What I don't understand is how you got here.	I assure you, there's nothing mysterious involved.
Did you know to come because one of the other men involved in the break- in called you?	There is no reason to assume other people were involved.
There is no reason to assume other people were involved.	Your clients were arrested with a walkie-talkie; they didn't need that to talk among themselves.
A Miami social occasion? (explaining) Mr. Rafferty told me the Cubans were from Miami.	;  her husband apparently had told her to call if he hadn't called her by then 
;  her husband apparently had told her to call if he hadn't called her by then 	It was really nice of you to come, since you'd only met him once.
It was really nice of you to come, since you'd only met him once.	Are you implying you don't believe me?
Are you implying you don't believe me?	I have nothing more to say.
I have nothing more to say.	You don't mind getting on people's nerves, do you?
What'd you find?	Beats me. These notebooks belonged to Cuban guys?
Beats me. These notebooks belonged to Cuban guys?	S'right.
OK, get on this W.House guy and do a better job then you did on McCord.	I did all right on McCord.
I did all right on McCord.	McCord is security coordinator for the Committee to Re-elect the President, otherwise known as CREEP? 
McCord is security coordinator for the Committee to Re-elect the President, otherwise known as CREEP? 	?  What the hell does that mean? 
?  What the hell does that mean? 	. " 
. " 	You can't believe that.
White House.	Howard Hunt, please.
Who's Colson, Harry?	The most powerful man in America is President Nixon, probably you've heard his name.
The most powerful man in America is President Nixon, probably you've heard his name.	Mr.  Mitchell we've already discussed.  Mr.  Colson is the President's special counsel.  
Mr.  Mitchell we've already discussed.  Mr.  Colson is the President's special counsel.  	Thanks, Harry. (looks at ROSENFELD) Know anything about Colson?
...crap...	Is mine better?
Is mine better?	What is it about my writing that's so rotten?
Carl?	Yeah?
It makes sense; Hunt worked for the C.I.A. and the White House was paranoid about Teddy Kennedy.	Mr. Bernstein?
Mr. Bernstein?	Yes, ma'am.
 A librarian and a secretary say Hunt looked at a book (shakes his head) Not good enough.  	I was told by this guy at the White House that Hunt was investigating Teddy Kennedy.
I was told by this guy at the White House that Hunt was investigating Teddy Kennedy.	How senior?
How senior?	You asking me to disclose my source?
You asking me to disclose my source?	Just tell me his title.
Just tell me his title.	I don't know titles.
I don't know titles.	Is he on the level of Assistant to the President or not?
Follow the money. Always follow the money.	To where?
So tell me about the Times article.	What do you want to know?
Something maybe big.	And that makes anything you do OK, is that it?
Hey... very tense.	(sighs) How much did the damn bike cost? 
I think.	Give me your checkbook then.
Give me your checkbook then.	It's right under that pile.
It's right under that pile.	I thought you had to get to Miami.
I thought you had to get to Miami.	There's always a later plane.
Hi, it's me. I'm still here.	I'm so glad.
I'm so glad.	I'd really like to see Mr. Dardis.
I'd really like to see Mr. Dardis.	And you will. But not now.
And you will. But not now.	I called him from Washington. He's the one who asked me to be here at eleven in the morning.
You want Barker's phone stuff or his money stuff?	Whatever.
Whatever.	I'll never get out of here in time.
Were you after the Dahlberg articles from the files? There aren't any, sorry.	Whazzis?
...you're definitely doing a story...?	Yes, sir.
Yes, sir.	I know I shouldn't tell you this. . .  
I know I shouldn't tell you this. . .  	That twenty-five thousand dollars is money I collected for Nixon in this year's campaign.
That twenty-five thousand dollars is money I collected for Nixon in this year's campaign.	I see. And how do you think it reached Miami?
I see. And how do you think it reached Miami?	How it got to that burglar, your guess is as good as mine.  
What'd'ya think?	Politics as usual, someone just got caught with his hand in the cookie jar, that's all.
If you don't like it down there, why don't you quit?	I don't know what they'd do to me.
I don't know what they'd do to me.	Hey, easy...
The Mitchells.	Can I speak to Martha Mitchell, please.
Left up ahead.	Who's first?
No, I'm a reporter. I wanted to talk to you about the Committee to Re- Elect.	The what to what?
The what to what?	You work there, Miss Abbott.
Miss Abbott?	Yes?
You had the Mighty Mo and the fries without gravy, right?	This is terrific work, if you like rejection.
This is terrific work, if you like rejection.	I never scared anyone before.
I never scared anyone before.	It's not us, they were scared before we got there. What do we know?
It's not us, they were scared before we got there. What do we know?	Facts or theory?
Facts or theory?	Anything you've got.
It's just so I can keep things straight.  Start with the money, why don't you? 	How do you like it?
How do you like it?	Everything, please.
I can't be positive that it was used for the break-in but people sure are worried.	Which people?
Which people?	The ones who could disburse the money.
Morning or night?	Night.
(WOODWARD says nothing, waits) Are we right on this story? 	I think so.
I think so.	Are you sure?
It may never come out.	Never? Please don't tell me never. Ben says you've found some wonderful sources.
Never? Please don't tell me never. Ben says you've found some wonderful sources.	Some Justice Department lawyers and an FBI man, and some people from the Committee to Re-Elect, yes ma'am.
Some Justice Department lawyers and an FBI man, and some people from the Committee to Re-Elect, yes ma'am.	And the underground garage one. Would I know him?
And the underground garage one. Would I know him?	I couldn't say.
I couldn't say.	But it's possible.
But it's possible.	It is.
It is.	?  But you'd have to tell me if I asked you (WOODWARD nods) Tell me.  
?  But you'd have to tell me if I asked you (WOODWARD nods) Tell me.  	I would, if you really ever wanted to know.
I wasn't serious. I have plenty of burdens to carry around, I don't need another.	We're going to need lots of good luck, aren't we?
My paper sent me out to see if I couldn't persuade you to go on the record.  	You can't.
I know where Dwight works.	When did he hire you?
When did he hire you?	Do you feel much about the things you did?
Do you feel much about the things you did?	I didn't do anything wrong.
I didn't do anything wrong.	Tell that to Muskie.
Tell that to Muskie.	Oh, maybe nickel and dime stuff.
I didn't.	But you know who did.
My turn to keep you waiting. What's the topic for tonight?	Ratfucking.
Do you guys know about the Canuck letter?	Um-hmm. (stops, looks at her) Why?
That's a bullshit question, that's a question straight out of Wichita, Kansas.	Sorry, Ken; listen, one last thing: where did your talk with Berger happen?
For Chissakes, don't tell them I came to your place.	I already told them.
I already told them.	Oh, that's terrific, that's just so terrific, I'm thrilled you did that.
Oh, that's terrific, that's just so terrific, I'm thrilled you did that.	I have a clear conscience.
He just did.	He'll give us a sworn statement.
You fucked around my life, you two. I just wanted to say thanks.	?  You had a good source ?  (nod) Did he have an ax ?  (pause Then another nod) 
I think that's him.	Who?
Well, we are trying to ruin his life.	It's nothing personal, though.
It's nothing personal, though.	What's the matter?
What's the matter?	Same as Magruder, I don't like it when they turn out to be human.
Same as Magruder, I don't like it when they turn out to be human.	I wish we were investigating Attila the Hun.
...You shouldn't ever call me like this, Carl...	Will you confirm that Haldeman was mentioned by Sloan to the Grand Jury?
Woodward?	Hmm?
Hmm?	;  after all these months our credibility's gone, you know what that means? 
We can't trust the phones, not anymore. Deep Throat says so.	We can't talk inside either?
So I guess you could say that we screwed up, but we weren't wrong.	Anything else from Mr. Throat?
