I hope you found our little parish to your liking.  	I just never expected they would bring about such a. . .  such a reckoning.  
. .  	Rule of thumb?
No way. You know how big a guy's gotta be to do that? Fuckin' huge.	Oooo. I might be wanting a bagel with my coffee.
Know what we need, man?... some rope.	For what?
For what?	Charlie Bronson's always got rope.
Charlie Bronson's always got rope.	What?
Oh, you've lost it, haven't ya?	I'm serious.
I'm serious.	Me too. That's stupid. Name one thing we're gonna need it for.
Me too. That's stupid. Name one thing we're gonna need it for.	I don't know they just always need it.
I don't know they just always need it.	What is all this "they" shit? This ain't a movie.
What is all this "they" shit? This ain't a movie.	Is that right, Rambo?
Uh,huh. Room number.	We got a time of death?
We got a time of death?	What's the body count?
What's the body count?	Uh, huh.
Uh, huh.	I'll be down there in a bit. Keep the press out.
I'll be down there in a bit. Keep the press out.	What are you doing?
What are you doing?	I was just trying to cuddle.
He's struck again, hasn't he, Greenly?	Why do you always disrespect me like that?
Nervous?	A bit.
A bit.	Me, too.
We're doing some serious shit here. Now, get a hold of yourself, asshole.	Asshole!? I'm not the rope-totin' Charlie Bronson wanna-be that's getting' us lost!
Asshole!? I'm not the rope-totin' Charlie Bronson wanna-be that's getting' us lost!	Sh, sh! Fuck you!
Anybody you think is evil?	Yes.
Yes.	Don't you think that's a little psycho? A little weird?
Who were the victims?	A couple of peons for the mob and...
A couple of peons for the mob and...	I want the crime scene photos and any witness statements.  NOW !  
Hello?	Hey, Murph.
Hey, Murph.	Roc. You okay?
Roc. You okay?	Yeah. Anybody call for me?
Yeah. Anybody call for me?	No. You sure you're okay?
You guys gotta teach me that prayer, man. That's some good shit.	Forget it. It's a family prayer. My father, his father before him that sort of shit.
Fuck you.	Hey, Augustus, I need your help, I got a serious problem here. I'm not screwing around.
Hey, Augustus, I need your help, I got a serious problem here. I'm not screwing around.	And when you took the wheel, who was beside you? 
And when you took the wheel, who was beside you? 	Hey, I just...
Hey, I just...	What am I, a retired bus driver? 
What am I, a retired bus driver? 	I need Il Duce.
I need Il Duce.	The Duke? What did you do?
The Duke? What did you do?	I mean I had a prodigy on my hands the whole time and didn't even know it.  
I mean I had a prodigy on my hands the whole time and didn't even know it.  	Listen kid, I think you better understand who you're dealing with here.
Don't even know if he's still alive.  Or if he's even up to it.  	There's ways around that.
Why don't you come down ?  Wife makes a hell of a bar-g-que.  	Yeah... yeah, I'd like that. Tell me something. What did they do?
Don't fuck with me lady. I'll kill you.	But, judging by the burn mark on her back, I think what they did. . .  
But, judging by the burn mark on her back, I think what they did. . .  	...was use a stun gun on her.
Now they are staring at six guys with guns drawn. It was a fucking ambush.	!  For a few seconds this place was Armageddon !  There was a fire fight !  
What if it was just one guy with six guns?	Why don't you let me do the thinking, huh, genius?
!  Even if we get suspects in this case, we got nothing. .  Nothing !  	 I've never seen any-fucking-thing like this in my whole fucking life Who the fuck are they? !  !  
You've had quite a bit, Paul. Are you sure you...	Pour the drink, faggot-ass!
You gonna do what I say, got it?	Yes.
Yes.	I'm sorry you're gonna hafta see this. Don't look at me!
I'm sorry you're gonna hafta see this. Don't look at me!	I'm sorry, I'm sorry. I didn't see.
And it looked like he had a gray beard, maybe. . .  late fifties, early sixties.  	So you're telling me it was one guy with six guns? A-and he was a senior fucking citizen?
So you're telling me it was one guy with six guns? A-and he was a senior fucking citizen?	I think it's better if we find this man before he finds us again.
I think it's better if we find this man before he finds us again.	I'll see what I can do. How do I get in touch with you?
I'll see what I can do. How do I get in touch with you?	Then we move on to New York.  It's getting a bit hot for us here.  
Then we move on to New York.  It's getting a bit hot for us here.  	Be careful.
I don't know who he is. Nobody does.	What did he bring him in for?
What did he bring him in for?	Needed an outsider. The package boy knows everyone. He'd spot our hitters a mile away.
Needed an outsider. The package boy knows everyone. He'd spot our hitters a mile away.	Just for him?
Just for him?	Says he's real good, got every available gun in the city up there.  
Says he's real good, got every available gun in the city up there.  	Up where?
Up where?	 I don't know what's going on but I know it's gotta have something to do with this kid 
How long do these put a man down for?	Ten minutes.
Yes. I was there.	How do you feel about what they did?
