Hiya, Carrie. Gee you gave me a fright. How long have you been there?	What are those?
What are those?	Those are my breasts, honey.
Those are my breasts, honey.	I wish I had some.
I wish I had some.	You will. `Course you'll have to wait a couple of years, but �
You will. `Course you'll have to wait a couple of years, but �	No I won't.
No I won't.	Why, sure you will.
...dirtypillows.	What?
Mother, we've got to do something!	What?
What?	Call the police? Mother, call the police!
Carrie!	Yes, Momma.
Yes, Momma.	You come straight home from school.
`Beautiful.' `Bee-t-ti-ful!' `Oh beautiful for spacious skies, for amber waves of grain.' Is that the beautiful you mean?	Anyone else ?  (no one else) Well, at least we've finally gotten Carrie White to say something !  
Anyone else ?  (no one else) Well, at least we've finally gotten Carrie White to say something !  	You suck.
You suck.	Tommy? You said something?
Never mind the coin slot... It's broken.	It hurts... my stomach...
It hurts... my stomach...	Do it! Now.
Do it! Now.	I can't. I don't know how!
I can't. I don't know how!	What...?
Ah, yes.	Morty, until a half hour ago, I don't think she knew there was such a thing.
Morty, until a half hour ago, I don't think she knew there was such a thing.	It's hard to believe in this day and age a girl in high school wouldn't know... something... the facts.
It's hard to believe in this day and age a girl in high school wouldn't know... something... the facts.	Well, knowing that mother of hers...
Well, knowing that mother of hers...	As for the girls � 
As for the girls � 	Carrie's always been their scapegoat. So they...
Carrie's always been their scapegoat. So they...	You'll have to do something.
You'll have to do something.	The whole thing just made me want to take the girl and shake her.  
The whole thing just made me want to take the girl and shake her.  	Ummm.
Ummm.	It's just her period, for God's sake.
Hey, fart-face! Hey, old praying Carrie!	Fart-face, fart-face, fart-face...
Fart-face, fart-face, fart-face...	Fart-face!
Oh, Mrs. White.	How have you been, Mrs. Snell?
How have you been, Mrs. Snell?	Fine.
Fine.	And the doctor?
And the doctor?	Fine.
Sue is... fine.	Won't you come in, Mrs. White?
Won't you come in, Mrs. White?	Thank you.
Thank you.	I think Carrie is in some of Sue's classes.
I think Carrie is in some of Sue's classes.	Yes.
Yes.	Perhaps some time Carrie might visit...
Perhaps some time Carrie might visit...	I'm here on the Lord's work.
I'm here on the Lord's work.	Yes, of course.
Yes, of course.	These will interest the doctor and you.
These will interest the doctor and you.	I'm sure they will.
I'm sure they will.	And your daughter.
Children are godless these days, Mrs. Snell.	My Sue is a good girl.
My Sue is a good girl.	These are Godless times.
These are Godless times.	I'll drink to that!
I'll drink to that!	We'll all read... these.
We'd like to contribute ten... ...twenty dollars.	Thank you. I'll give you a receipt.
Thank you. I'll give you a receipt.	Thank you, Mrs. White.
That's Carrie White's mother...	What did she want?
What did she want?	She gave us these � (conspiratorial sigh) ...and I gave her a donation.
You're a woman now.	Oh Momma, why didn't you tell me something? I was so scared...
Oh Momma, why didn't you tell me something? I was so scared...	 And Eve was weak and loosed the raven on the world, and the raven was called Sin � ` 
 And Eve was weak and loosed the raven on the world, and the raven was called Sin � ` 	...and the raven was called sin...
...and the raven was called sin...	Why didn't you tell me? Oh, Momma �
I was so scared! And the other girls, they made fun of me and threw things and �	Momma, please listen. It wasn't my fault.
Momma, please listen. It wasn't my fault.	Momma!
Momma!	And Eve was weak and... say it, woman!
And Eve was weak and... say it, woman!	Momma, please help me.
Momma, please help me.	And Eve was weak and loosed the raven on the world.
And Eve was weak and loosed the raven on the world.	They threw things...
They threw things...	...and the raven was called Sin... Sin! ...and the first sin was intercourse.
...and the raven was called Sin... Sin! ...and the first sin was intercourse.	Momma, please listen.
You should have told me!	Show her that if she had remained sinless � 
No, Momma.	?  I can see your sin just as surely as God can 
?  I can see your sin just as surely as God can 	Momma, let me go.
Momma, let me go.	We will pray. We will pray, woman, we will pray to Jesus for our woman-weak, wicked, sinning souls...
Hey.	Hey, what's the matter?
Hey, what's the matter?	Nothing.
Nothing.	What did I do?
Hey, everything's all right. I love you, honey. Did I...?	It's Carrie.
It's Carrie.	Who?
Who?	Carrie. Carrie White.
Carrie. Carrie White.	Praying Carrie?
Praying Carrie?	Don't call her that.
Don't call her that.	It's... beautiful. (laughing) That's what she said when I read that poem you wrote for me.
It's... beautiful. (laughing) That's what she said when I read that poem you wrote for me.	Tommy, please...
Tommy, please...	And Big Belly Fromm saying... (imitating) That isn't exactly criticism, Miss White. (exploding) Jesus!
Don't call me that.	Don't call her that. Don't call me that. What the hell's the matter with you?
Don't call her that. Don't call me that. What the hell's the matter with you?	Hey, are you crying? Are you?
Hey, are you crying? Are you?	Jesus, Sue, what is it?
Jesus, Sue, what is it?	I told you.
That thing in the shower? Hey, it was a joke, wasn't it? I mean, everyone was doing it.	I'm not everyone.
I'm not everyone.	You're special.
You're special.	I was one of them.
That's not enough. That's like something my mom would do.	What are you going to do? Kiss her, for God's sake?
What are you going to do? Kiss her, for God's sake?	God, I hate you sometimes!
God, I hate you sometimes!	What the hell do you want me to do?
What the hell do you want me to do?	I want you to help me. Or are you just interested in fucking me?
I want you to help me. Or are you just interested in fucking me?	Don't say that!
Don't say that!	Fucking me, fucking me...
Fucking me, fucking me...	Cut it out!
Cut it out!	Then help me!
Then help me!	Okay, what can I do?
.  Jesus !  (moment) Are you serious ?  (moment) You're serious.  (moment) What's there to think about? 	Think about it.
Think about it.	Jesus.
Jesus.	(beat) You know what I mean? 
The period's not up, Hargensen.	It is for me.
It is for me.	There are ten minutes left.
There are ten minutes left.	Stick them up your ass.
Stick them up your ass.	You can't hit us! You'll get canned for this, you bitch! My father �
Hey, Sue! Just who I've been looking for!	I wanted you to sign my yearbook. Hey, where's you old man, did he stand you up?
It was a shitty thing to have done.  End of statement.  	Bullshit! That goddamn snerd and her batshit mother � saying we're all going to hell.
Bullshit! That goddamn snerd and her batshit mother � saying we're all going to hell.	What'd she ever do to you, Chris? Or to any of us? Why do you hate her so much?
What'd she ever do to you, Chris? Or to any of us? Why do you hate her so much?	Hey, hey... tell me if I'm wrong, but who was that n there pitching with the rest of us?
Hey, hey... tell me if I'm wrong, but who was that n there pitching with the rest of us?	Me. Me. But I stopped.
Me. Me. But I stopped.	Oh. Oh, aren't you just it? Oh, my, yes. (imitating; prissy) You stopped. Hey, Billee, she stopped.
?  So just stop again Why didn't you walk out ?  Why didn't you walk out, Sue? 	Okay, Chris. That's enough.
Okay, Chris. That's enough.	 little Suzy Creamcheese. .  because you didn't want to miss a moment of your precious prom.  
 little Suzy Creamcheese. .  because you didn't want to miss a moment of your precious prom.  	And you don't?
And you don't?	(beat) I'll bet you've got your dress all picked out, too.  What color is it ?  Yellowguts? 
Hi!	I want to talk to you.
I want to talk to you.	Sure, what's up?
Sure, what's up?	If I asked you to do something for me � something special � would you?
If I asked you to do something for me � something special � would you?	Uh-huh.
Uh-huh.	No matter how crazy it sounded?
No matter how crazy it sounded?	Sure. What?
Goddamnit, Billy!	Slow down! (as he pays no heed) Slow down, you stupid shit!
Slow down! (as he pays no heed) Slow down, you stupid shit!	Scared, Chuckie?
Don't call me that.	Stupid shit.
Stupid shit.	Stupid shit.
What's wrong?	Can't you wait a minute?
Can't you wait a minute?	What for?
What for?	You're so ignorant.
Bullshit.	No? I'll show you what you like, Chuckie.
No? I'll show you what you like, Chuckie.	No.
No.	Jesus.
Jesus.	No!
No!	...How you... gonna... explain that...
...How you... gonna... explain that...	Dumb shit!
Dumb shit!	What'd I tell you?
What'd I tell you?	Hell is this?
I thought you had gym this period.	What're you reading?
What're you reading?	It's about... um.. sewing...
It's about... um.. sewing...	Umm... if you don't have a date for the Prom, would you want to go with me?
Umm... if you don't have a date for the Prom, would you want to go with me?	What?
What?	The Prom...
The Prom...	...It's next Friday, and I know this is later notice, but they stop selling tickets soon, and �
...It's next Friday, and I know this is later notice, but they stop selling tickets soon, and �	I don't like to be tricked.
?  Did one of the girls do something to you ?  Do you want a Kleenex? 	No.
No.	It's all right. Just tell me, there's nothing to be afraid of.
It's all right. Just tell me, there's nothing to be afraid of.	Miss Collins...
Miss Collins...	That's it...
That's it...	When can I come back to gym?
When can I come back to gym?	Not until Monday. Now what is it? Are you going to tell me? Come on, Carrie, tell me.
Not until Monday. Now what is it? Are you going to tell me? Come on, Carrie, tell me.	I got asked to the prom.
I got asked to the prom.	That's great!
That's great!	Tommy Ross asked me.
I know who he goes around with. They're trying to trick me again. I know.	It might be really fun.  You might have a really good time !  
It might be really fun.  You might have a really good time !  	It would be a nightmare.
Carrie's been asked to the prom.	Who?
Who?	Carrie White.
Carrie White.	By whom? The Beak?
By whom? The Beak?	By Tommy Ross.
Who's brainstorm was this? What are you trying to do?	You've got it wrong.
You've got it wrong.	I hope so. I wouldn't have expected this from you, Sue. Not any of it. Well?
I hope so. I wouldn't have expected this from you, Sue. Not any of it. Well?	What do you want to know?
What do you want to know?	Why Tommy asked her to the prom. Well?
Why Tommy asked her to the prom. Well?	I asked him to.
I asked him to.	Why?
Why?	I asked him to.
Aren't you going to ask me in?	Why not?
Why not?	Momma's resting. What do you want?
Momma's resting. What do you want?	Right to the point, huh? Okay, about the prom.
Right to the point, huh? Okay, about the prom.	I already told you.
I already told you.	Nothing to stop you changing your mind. Girls do it all the time.
Nothing to stop you changing your mind. Girls do it all the time.	Why are you doing this?
Why are you doing this?	Hey, I'm asking you because I want to.
Hey, I'm asking you because I want to.	No.
No.	Look, I don't do anything I don't want to.
Look, I don't do anything I don't want to.	I can't.
Yes. Okay.	I'll pick you up at eight.
I asked Tommy to take Carrie. I thought I owed her that much.	Where does that put the rest of us?
Where does that put the rest of us?	You have to make up your own mind.
You have to make up your own mind.	And Tommy went along with it?
And Tommy went along with it?	Uh-huh. I guess the other kids think I'm stuck-up.
There is... ...a small dissenting faction.	I guess she's having a field day with this.
You haven't touched your pie, Carrie.	It makes me have pimples, Momma.
It makes me have pimples, Momma.	Your pimples are the Lord's way of chastising you.
Your pimples are the Lord's way of chastising you.	Momma?
Momma?	Yes?
Yes?	Momma, please see that I have to start to get... to try and get along with people.
Momma, please see that I have to start to get... to try and get along with people.	Whatever are you going on about? Have you been showering with the other girls again?
Whatever are you going on about? Have you been showering with the other girls again?	I... I've been invited to the prom.
I... I've been invited to the prom.	Prom?
It's that teacher, the one that called. She'll be sorry.	I want to try and be a whole person before it's too late to � 
I want to try and be a whole person before it's too late to � 	His name is Tommy Ross, and he's a very nice boy. He's �
The closet.	No.
No.	After all you've been taught �
After all you've been taught �	Everyone isn't bad, Momma, everything isn't sinful.
Everyone isn't bad, Momma, everything isn't sinful.	Go to your closet and pray. Ask to be forgiven!
Go to your closet and pray. Ask to be forgiven!	You'll like this boy, he....
You'll like this boy, he....	Boys. Yes, boys come next. After the blood, the boys come. Like sniffing dogs...
Boys. Yes, boys come next. After the blood, the boys come. Like sniffing dogs...	Momma �
Momma �	...grinning and slobbering, trying to find out where the smell comes from, where the smell is. That... smell!
...grinning and slobbering, trying to find out where the smell comes from, where the smell is. That... smell!	Please stop...
Please stop...	Roadhouses.  Music.  Whiskey.  I've seen it, all right.  Oh, yes.  
Roadhouses.  Music.  Whiskey.  I've seen it, all right.  Oh, yes.  	Momma, you better stop.
I've already said I would, Momma.	Then say no. Say no. Or we'll move.
Then say no. Say no. Or we'll move.	No.
No.	We'll move from here and you'll never see that boy again.
We'll move from here and you'll never see that boy again.	The rain's coming in.
The rain's coming in.	Momma, sit down.
Momma, sit down.	I'm going to close the windows.
I'm going to close the windows.	I'll get them. Please sit and talk to me.
I'll get them. Please sit and talk to me.	No.
Witch!	It's Satan's power. First he entered your father, carried him off...
It's Satan's power. First he entered your father, carried him off...	He ran away, Momma. Everyone knows that.
He ran away, Momma. Everyone knows that.	The devil tempted him.
The devil tempted him.	He ran away with a woman, Momma.
He ran away with a woman, Momma.	All men are the same. That boy, he's like all the rest, he doesn't �
Hell of a risk for a joke.	You want out?
You want out?	No, uh-uh. (then) It's a good joke, Billy.
No, uh-uh. (then) It's a good joke, Billy.	Hey, piggie...
Red. I might have known it would be red.	Only clearing the thread, Momma.
Oh, momma.	He has given you a power.
He has given you a power.	It's me.  If I concentrate hard enough, I can make things move.  
It's me.  If I concentrate hard enough, I can make things move.  	Satan is clever.
Satan is clever.	Momma, there are other people... people with the power... It's a part of me.
Momma, there are other people... people with the power... It's a part of me.	Satan...
Satan...	If it were, I'd know it.
If it were, I'd know it.	You poor child. He doesn't let you know he's working through you.
You poor child. He doesn't let you know he's working through you.	Momma, I'd know.
Momma, I'd know.	You are to renounce this power. You must give it up. You must never use it.
You are to renounce this power. You must give it up. You must never use it.	I'm going to do my homework, Momma.
What's it like up there? Billee? (no answer; genuinely scared) Billy!	Boo.
Boo.	You stupid shit.
You stupid shit.	Nice talk.
Nice talk.	Hurry up. Do you hear me, just hurry up.
Hurry up. Do you hear me, just hurry up.	Yes'um. Yes'um. Weeze doing the best we can.
Yes'um. Yes'um. Weeze doing the best we can.	I want to go home.
I want to go home.	Just keep your tits on and I'll let you pull it when the time comes.
Come in, Momma.	Do you want to pin it on, Momma?
Do you want to pin it on, Momma?	I can see your dirtypillows. Everyone will.
I can see your dirtypillows. Everyone will.	Breasts, Momma, breasts. Every woman has them.
Breasts, Momma, breasts. Every woman has them.	Take off that dress.
We'll burn it together, we'll pray for forgiveness.	No, Momma.
No, Momma.	He's not coming.
He's not coming.	Stop it, Momma. I'm nervous enough.
Stop it, Momma. I'm nervous enough.	Stop hurting yourself, Momma. That's not going to stop me either.
Stop hurting yourself, Momma. That's not going to stop me either.	Go away, Momma.
Go away, Momma.	You know I'm right. He'll laugh at you. They'll all laugh at you.
You know I'm right. He'll laugh at you. They'll all laugh at you.	No. It'll be okay.
No. It'll be okay.	It's not too late. You can stay here with me.
I'll answer the door and say you're sick, I'll say �	Momma, sit on the bed.
Momma, sit on the bed.	I'll say that you changed your mind, I'll say �
I'll say that you changed your mind, I'll say �	`Thou shalt not suffer a witch to live.'
It's like a dream.	You can still change your mind, you know.
You can still change your mind, you know.	Easier said than done.
Easier said than done.	C'mon.
C'mon.	No. Please � not yet.
Yes. Can we sit here another minute?	Tommy... Maybe... maybe this was a mistake.
Tommy... Maybe... maybe this was a mistake.	Hey, it won't be so bad.
Carrie, anything that happened before... well, it's all forgotten. I want you to know that.	I can't forget it. But it's over with. It's over.
I can't forget it. But it's over with. It's over.	But I've never had a date like it, ever since.  Is it like that for you? 
But I've never had a date like it, ever since.  Is it like that for you? 	It's very... nice.
It's very... nice.	Just nice?
Just nice?	No. There's more. I don't know... ...it's like being on Mars.
No. There's more. I don't know... ...it's like being on Mars.	You'll never forget it.
You'll never forget it.	I think you're right.
I think you're right.	Thank you.
I've never been there.	Hey, great. We'll have the place all to ourselves. Great! Then it's settled.
Hey, great. We'll have the place all to ourselves. Great! Then it's settled.	Tommy...
Tommy...	C'mon...
C'mon...	I don't... I can't... I...
It's just...	No harm, no foul.
No harm, no foul.	I don't know... anything. I can't dance...
I don't know... anything. I can't dance...	You danced.
You danced.	I don't even know how to...
I don't even know how to...	It's easy.
It's easy.	Tommy... why?
Tommy... why?	Why what?
Why what?	Why am I here?
With you.	Because I asked you. And...
Because I asked you. And...	Why? Why did you?
Why? Why did you?	Because I wanted to.
Because I wanted to.	Why?
Why?	Because...
Because...	...you liked my poem. Only I didn't write it. Someone else did.
...you liked my poem. Only I didn't write it. Someone else did.	Oh.
Oh.	Look, Carrie, we're here, we're together... and I like it, you know... I mean, I...
Look, Carrie, we're here, we're together... and I like it, you know... I mean, I...	But...
Tommy... ...we're on here!	I know. Want to decline?
I know. Want to decline?	Do you want to?
Do you want to?	Besides, it's the last year.  
Besides, it's the last year.  	They're beautiful.
They're beautiful.	You're beautiful.
Whatever you like.	In fact, I don't really have a crowd.
In fact, I don't really have a crowd.	Let's vote for ourselves. To the devil with false modesty.
Let's vote for ourselves. To the devil with false modesty.	Hurt yourself?
Hurt yourself?	No. But I broke it and it was a souvenir.
We've got a tie.	Polka-dot or striped?
I thought you said they'd win.	They will. They will. Won't even be close.
They will. They will. Won't even be close.	If you screwed up...
What're you doing here, young lady?	Something's wrong!
Goddamnit!	Billy!!!
I should have killed you when you were born.	Momma, I love you. Please help me!
Momma, I love you. Please help me!	Sin never dies.
No.	Get out.
Get out.	We were just trying to...
We were just trying to...	Get out.
Get out.	Get out! Get out!
