I'm sorry, sir. This cabin is restricted to first cl...	Is this what you're looking for?
Is this what you're looking for?	Oh, I'm sorry. Please. Is there anything I can get you?
Another movie from an old TV show?	Well, what're you gonna do?
Well, what're you gonna do?	Walk out.
Walk out.	That's very funny.
It's a mistake. A horrible, horrible mistake.	Then how come we keep getting back together? It's fate.
If you don't defuse this bomb, Logan, L.A.'s going to be a new underwater attraction.	Get off my back, Sanchez. I know what I'm doing.
Get off my back, Sanchez. I know what I'm doing.	Which wire? The red one or the blue one?
Which wire? The red one or the blue one?	Marix has a thing for red. Red cars, red boats, red-headed hookers.
Marix has a thing for red. Red cars, red boats, red-headed hookers.	So the red one.
So the red one.	That's why I'm gonna say blue.
That's my job.	I don't think Sanchez would kiss me. He's a forty-year-old man.
I don't think Sanchez would kiss me. He's a forty-year-old man.	Let's have it rewritten.
Try to get Corwin to talk about the industry, Knox, anything.	Understood.
Understood.	I'm going undercover.
So, what business are you in?	Computers. Software.
Computers. Software.	Computers, hunh? What do you know about this new browser from Knox Technologies?
Computers, hunh? What do you know about this new browser from Knox Technologies?	Word on the street is, once they raise capital, they'll rule the industry.
Word on the street is, once they raise capital, they'll rule the industry.	I don't see that happening.
Please to take off clothes, Mr. Corvin.	Let me see if I can vork it out.  
Let me see if I can vork it out.  	Just by activating ze right energy points, you can improve ze circulation, alleviate pain, or. . .  
Can you not drive my car so fast, Dyl? I'm trying to type.	I drive too fast. Look who's talking.
I drive too fast. Look who's talking.	Three double doubles, animal style. Fries. Three chocolate shakes.
Keppler-Wilson.	For my money, Keppler-Wilson is a strong choice.
He's cute.	I'm working.
I'm working.	Sixty-five percent of relationships begin in the workplace.
Sixty-five percent of relationships begin in the workplace.	He's a bartender. I need dependable. I need reliable. I need a Volvo man.
He's a bartender. I need dependable. I need reliable. I need a Volvo man.	Miss! Miss! I'd love some champagne.
I'm Natalie.	Pete. Good to meet you.
Pete. Good to meet you.	Listen, there's an animation festival at the Egyptian this week. I was wondering if you might want to...
I'm on it.	Vegetarian spring roll?
Vegetarian spring roll?	Two guns. One ankle, one shoulder.
Two guns. One ankle, one shoulder.	You call it.
You call it.	You take point. I'll circle behind.
No, it wasn't.	I've seen this before, he's scrambling his calls through a secondary location.
I've seen this before, he's scrambling his calls through a secondary location.	In English?
Three shots of tequila, please. And one Tom Collins.	Hey baby, why don't you ditch that stiff and come sit on ma lap?
Hey baby, why don't you ditch that stiff and come sit on ma lap?	Ooh, that is an enticing offer. But I got a better idea. How about a shot contest? My treat?
Hey, I've got an idea. Now let's have a chair throwing contest.	Hunh?
Good news: I found Knox.	Bad news: I found company.
I think we're in the clear.	Or maybe not.
Or maybe not.	Oh God, no.
Also, stay away from the windows.	They're bullet-proof. The last owner was paranoid.
They're bullet-proof. The last owner was paranoid.	Lucky for us.
Lucky for us.	This is a panic button. Press it and one of us can be here in ten minutes.
This is a panic button. Press it and one of us can be here in ten minutes.	Which one of you?
Which one of you?	Whoever's closest.
Whoever's closest.	I have a better idea.
Stay for dinner. I'm a pretty good cook.	I can't Mr. Knox. I'm sorry. If you...
I can't Mr. Knox. I'm sorry. If you...	I'm scared.
I'm scared.	I know, you probably have other plans, but it would be very reassuring.  
I know, you probably have other plans, but it would be very reassuring.  	Come on, don't make me beg. I'm embarrassed already.
That's you, hunh? Cute kid. Cute family.	Thanks. It's the only picture I have of me with my parents. They died a week later.
But...?	Apparently, he was betrayed by one of his own team.  
Apparently, he was betrayed by one of his own team.  	Wow. That's a lot for a kid to live with.
Wow. That's a lot for a kid to live with.	Yeah, but it motivated me, losing my family. It still does. I don't take anything for granted.
Yeah, but it motivated me, losing my family. It still does. I don't take anything for granted.	Boy did I have you pegged wrong.
Boy did I have you pegged wrong.	How do you mean?
How do you mean?	I've got instincts for the job, but when it comes to men ?  Well. . .  
Oh. Well, you ARE, so...	Is there someone you need to be going home to?
Is there someone you need to be going home to?	No. But I...
No. But I...	I shouldn't.
I shouldn't.	Shouldn't you?
Shouldn't you?	No. I shouldn't.
No thanks to you! You're supposed to be my head of security! Who is that bitch?!	Don't know. I'll keep an eye out.
There's something going on between you and Knox. Isn't there?	So what, so I like him. Is that so wrong?
Alex, I can't tell you how happy I am you came.	Me too.
Me too.	It's weirding me out how happy I am when you're around.  Am I sick or something? 
It's weirding me out how happy I am when you're around.  Am I sick or something? 	Got me.
Got me.	What the hell am I gonna do this weekend, if you're not with me? 
What the hell am I gonna do this weekend, if you're not with me? 	We'll get you some sedatives. You'll be fine.
We'll get you some sedatives. You'll be fine.	Hey. Wait a second. Come with me!
Hey. Wait a second. Come with me!	Come with you?
Come with you?	Miami, on the Sony Jet. I've got two tickets to the Final Four.
Miami, on the Sony Jet. I've got two tickets to the Final Four.	Jason, I don't...
Jason, I don't...	I'm sick of stealing a day here, or a week there.  
I'm sick of stealing a day here, or a week there.  	It's my job, Jason. I can't explain it, but I have to be on call, all the time, and...
What I'm saying, Alex, is that I want you to. . .  	Gunfire! Get down!
Gunfire! Get down!	My God, you're hit. You're...
Fake guns, too. They're just setting up for the next scene.	Sorry about that, I...
Really.	You're the most beautiful woman I've ever seen this close up.
You're the most beautiful woman I've ever seen this close up.	Ladies room. I'll be back in two minutes.
Who do you work for?	Speak now or never again.
Speak now or never again.	Jacket pocket.
Jacket pocket.	National Security Agency? You're with the NSA?
Where's that music coming from?	You'll see. Just a little farther.
That's amazing.	Can I ask you a personal question?
Can I ask you a personal question?	Maybe.
Maybe.	How much do you know about Charlie?
How much do you know about Charlie?	I just find it strange that you work for a man you've never met.
And none of you have any clue who he actually is?	Nope.
Nope.	And you're never curious to find out?
And you're never curious to find out?	Of course, but believe me, it's impossible. I've tried. Let's not talk about Charlie, okay? Or work.
Eric, it's Vivian.	Hmmm. I wonder what she's here for?
Hmmm. I wonder what she's here for?	Want me to tell her to come back, or...
She's a former assassin and an all around bitch.  	Oh no. OH SHIT. Natalie, she's HERE!
Oh no. OH SHIT. Natalie, she's HERE!	What?!
I'm ten minutes away. Wait until I get there.	I can't do that. Call Alex and meet me here.
I see you take your bodyguarding services seriously. Still, I worry that no one is watching the door.	Oh, I'm watching it. In fact, I just called for back up.
More of a cream, or an eggshell.  Vanilla.  Yes, I'm going to say vanilla.  	I can see the ocean.
I can see the ocean.	Bingo.
The National Security Agency's secret file on the man known as Charles Townsend.	Finally. How about Bosley? Did we get the information we wanted?
Finally. How about Bosley? Did we get the information we wanted?	Once we we drugged him, he sang like a bird.
Once we we drugged him, he sang like a bird.	Hmmm. Miami Arena. Preparations have been made?
Hmmm. Miami Arena. Preparations have been made?	Yes. We move out tonight.
Yes. We move out tonight.	Excellent. Where IS Bosley?
Excellent. Where IS Bosley?	In the tower. We were waiting till you gave the word.
See here? Look at the timer on the camera.	It's not moving. Oh, this is the oldest one in the book. Punch up camera three.
It's not moving. Oh, this is the oldest one in the book. Punch up camera three.	Now pan left.
Yeah, I sure as hell could.	Oh, right.
How do I get up to you?	There's a staircase. Look for a switch.
I'm not an insecure person or anything, and I've really enjoyed the very brief time we have spent together.	I'm just wondering if it's something I said or did that's making this whole thing so weird between us.
Yes, yes!	Charlie!? Charles Townsend!
Charlie!? Charles Townsend!	Alex?
Alex?	Jason? Shit.
Chartreuse and magenta. This has gotta be it.	I wouldn't do that, if I were you.
I wouldn't do that, if I were you.	See, if you snip ANY of those wires, the bomb WILL blow up.
See, if you snip ANY of those wires, the bomb WILL blow up.	It's gonna blow anyway, once the clock gets to zero.
It's gonna blow anyway, once the clock gets to zero.	Who told you that, my idiotic henchman? Do you think I tell him ANYTHING that's confidential?
He was my friend.  	It's still your fault, you arrogant prick! You still killed my father!
It's still your fault, you arrogant prick! You still killed my father!	?  If you hate me so much, just shoot ME Just shoot me, Eric.  
Great work, angels. You'll be happy to know you received another presidential commendation.	Enjoy your vacation, angels.
