No.	I said no.
I said no.	But you don't really mean it.
But you don't really mean it.	Yes I do. Keep it in your pants Rod.
Yes I do. Keep it in your pants Rod.	Maybe it won't stay in.
Maybe it won't stay in.	Maybe you better just drive me home.
Maybe you better just drive me home.	Let me just ask you a serious question first.
Let me just ask you a serious question first.	What?
What?	Aren't you worried you could die a virgin?
Aren't you worried you could die a virgin?	Yeah. I'm extremely worried about that. It's right up there with global warming.
Yeah. I'm extremely worried about that. It's right up there with global warming.	Terminate us instantly.  We'd never experience what it means to make love.  
Terminate us instantly.  We'd never experience what it means to make love.  	If sheep don't count.
If sheep don't count.	That wasn't me ...
That wasn't me ...	I know. I'm kidding you. Chill out.
I know. I'm kidding you. Chill out.	Well I'm trying to be real here and you're mocking me.
Stop it.	Rod!
Rod!	You're being unfair.
You're being unfair.	Unfair?!
Cut it out.	Why?
Why?	I was supposed to be home fifteen minutes ago.
I was supposed to be home fifteen minutes ago.	So? You're already late. A few more minutes won't matter.
So? You're already late. A few more minutes won't matter.	I got to get home.
I got to get home.	Fuck your curfew. Most sixth graders can stay out later than you.
You know, maybe we ought to start seeing other people.	What?
It's almost ten o'clock.	Daddy you scared me!
Daddy you scared me!	You're grounded Friday night!
What am I supposed to say? 'Nice sweater Mark'? 'Did you buy it at Eddie Bauer's?'	You could tell him you really liked the way he chews with his back molars.
You could tell him you really liked the way he chews with his back molars.	You're so fucking lucky your dad is the sheriff.
You're so fucking lucky your dad is the sheriff.	You are 'sp fucking' wrong.
You are 'sp fucking' wrong.	Everyone wants to meet you.  Party with you.  Have sex with you.  
He's just trying to mess with your head. Ignore him.	Does she fuck?
Yeah?	I'm Lisa Sherman. Dylan's aunt. He asked me to come talk to you.
I'm Lisa Sherman. Dylan's aunt. He asked me to come talk to you.	Why?
Why?	He feels terrible about those things he said to you in school.
He feels terrible about those things he said to you in school.	He should. Four guys hit on me today, and not because they find me intellectually stimulating.
He should. Four guys hit on me today, and not because they find me intellectually stimulating.	I think I know how to restore your reputation.
I think I know how to restore your reputation.	You do?
You do?	Can I come in? I'll need to use the phone.
Come in.	Hi honey.
Hi honey.	What's wrong?
What's wrong?	I have a question to ask you. A personal question.
I have a question to ask you. A personal question.	How personal?
How personal?	I need to know how far you and Kenny went?
I need to know how far you and Kenny went?	What do you mean?
What do you mean?	Well, I assume you let him kiss you?
Well, I assume you let him kiss you?	Well yeah. Of course. Everyone kisses.
Well yeah. Of course. Everyone kisses.	I'm not criticizing. _ Did you two get any further?
I'm not criticizing. _ Did you two get any further?	A little.
A little.	How much further?
Well?	She's still a virgin.
She's still a virgin.	Did you warn her?
If I'd gone public with this yesterday Annette Michaels might be alive today.	Oh GOD Brent, is there anything you don't feel guilty about?
Oh GOD Brent, is there anything you don't feel guilty about?	is there anything you do?
I just wanted to offer my services to Jody.	Your services?
Yes?	Are you Jody?
Are you Jody?	Yeah.
Yeah.	I'm Kenny's Aunt Lisa.
I'm Kenny's Aunt Lisa.	Kenny's aunt?
Kenny's aunt?	Yes. He asked me to come over and talk to you.
Yes. He asked me to come over and talk to you.	On what side of the family?
On what side of the family?	His mother's side.
IT'S LISA SHERMAN. But she still looks like we're eighteen.	That's impossible.
That's impossible.	I swear to God. It's her. She told Jody she was Kenny's 'AUNT LISA'. I'm getting this sickly feeling...
You were eavesdropping.	No I wasn't.
No I wasn't.	What did you hear?
What did you hear?	Nothing. I just picked up the phone to say goodbye to you. You didn't say goodbye.
You ok?	FINE. Are you?
FINE. Are you?	Hurricane Hormone. it's flattened the whole school. Guess what?
Hurricane Hormone. it's flattened the whole school. Guess what?	What?
What?	Mark invited me to the party.
Mark invited me to the party.	What party?
What party?	Shh. Ben's party. Tonight. Haven't you heard?
You can't tell your parents.	Ok.
Ok.	Especially not your dad.
Especially not your dad.	I won't.
I won't.	It's like a pop your cherry party. Everyone's saying it's 'Fuck or Die' time.
It's like a pop your cherry party. Everyone's saying it's 'Fuck or Die' time.	You're thinking of sleeping with Mark tonight?
You're thinking of sleeping with Mark tonight?	Unless he makes a move during seventh period.
Unless he makes a move during seventh period.	Didn't you have something a little more romantic in mind for your first time?
Didn't you have something a little more romantic in mind for your first time?	It'll be a lot less scary.  You have to go.  
It'll be a lot less scary.  You have to go.  	Stag?
Stag?	Kenny'll want to go with you. Cindy's holding a Q and A session at the bleachers. Come on.
Kenny'll want to go with you. Cindy's holding a Q and A session at the bleachers. Come on.	I can't right now.
Are you O.K.?	I'm fine.
I'm fine.	I heard you got attacked.
I heard you got attacked.	I did.
I did.	I was worried about you. Did you hear about the bash?
I was worried about you. Did you hear about the bash?	Yeah. I think it's really sick.
Yeah. I think it's really sick.	Why?
Why?	Three of our classmates are dead. That's not really the occasion for a party.
Three of our classmates are dead. That's not really the occasion for a party.	Nobody wants to be the fourth. Please go with me.
Nobody wants to be the fourth. Please go with me.	Did Sharon say no?
Did Sharon say no?	You know I want to go with you.
You know I want to go with you.	I'm so flattered but I can't. I'm grounded.
I'm so flattered but I can't. I'm grounded.	Everyone's grounded. There's a killer on the loose.
Everyone's grounded. There's a killer on the loose.	No I'm really grounded. When I got in late the other night, my father was waiting up for me.
No I'm really grounded. When I got in late the other night, my father was waiting up for me.	I'm so sick of it.  
Yes you are. You always do. It's why we broke up. You always hide behind him.	I do not.
I do not.	Jimmy's my ride.  Come over to my house after school.  We'll go together.  
Jimmy's my ride.  Come over to my house after school.  We'll go together.  	I have to go home after school. I have something really important I have to ask my mom.
I have to go home after school. I have something really important I have to ask my mom.	They're not picking me up until six.
They're not picking me up until six.	I'll think about it.
Hi.	Hi, I'm Mike Stanton.
Hi mom.	Hi princess.
Hi princess.	Mom?
Mom?	Yes?
Yes?	I need to ask you something.
I need to ask you something.	You can ask me anything.
You can ask me anything.	Have you ever heard of someone named Lisa Sherman?
Have you ever heard of someone named Lisa Sherman?	Lisa Sherman?
Lisa Sherman?	Yeah. Who is she?
Yeah. Who is she?	I don't know. Where did you hear that name.
I don't know. Where did you hear that name.	I overheard daddy mentioning her to someone. I he thinks she's the killer.
I overheard daddy mentioning her to someone. I he thinks she's the killer.	What?
What?	That's what he said.
That's what he said.	Did he say anything else about her?
Did he say anything else about her?	No but he got really weird. Like I've never seen him act. REALLY angry and super uptight.
No but he got really weird. Like I've never seen him act. REALLY angry and super uptight.	I've never heard of her. Maybe something else was on his mind.
I've never heard of her. Maybe something else was on his mind.	No. I think she lived her a long time ago. Like twenty-eight years ago. When dad was eighteen.
No. I think she lived her a long time ago. Like twenty-eight years ago. When dad was eighteen.	Not that I know of.
Not that I know of.	Where are you going?
What's the address? Thanks.	You found her?
You found her?	There's a Lisa Shermer living just sixty miles west of here. Over the Indiana border. I'm going.
There's a Lisa Shermer living just sixty miles west of here. Over the Indiana border. I'm going.	We need you here. I can bring her in.
As bizarre as it may sound, seems someone is planning to have a big party tonight.	No?
No?	Should we close down any eruption?
Should we close down any eruption?	Are you sure?
Are you sure?	We're seeing all the signs in town.
Hi Jody. What can I DO for you?	Hi Miss Dunlop. Where do you keep the old town papers?
Hi Miss Dunlop. Where do you keep the old town papers?	They're all on microfiche. What year are you looking for?
They're all on microfiche. What year are you looking for?	Twenty eight years ago.
This place is empty.	Everyone's getting ready for the party.
Everyone's getting ready for the party.	You heard about that?
You heard about that?	Of course. NO ONE EVER SHUTS UP IN THE LIBARY. Kids were whispering about it all day.
Of course. NO ONE EVER SHUTS UP IN THE LIBARY. Kids were whispering about it all day.	Don't you think it's sick?
Don't you think it's sick?	Not at all. In fact, I thought about going.
Not at all. In fact, I thought about going.	You Miss Dunlop?
You Miss Dunlop?	Unfortunately I qualify. Think I'm too old?
Unfortunately I qualify. Think I'm too old?	No.
Is that you Miss Dunlop?	Who's there?
Who's there?	Mom? You were spying on me.
Mom? You were spying on me.	I want you to come home with me right now, Jody.
I want you to come home with me right now, Jody.	Who is she?
Who is she?	She's nobody you should be concerned with.
She's nobody you should be concerned with.	I think that concerns me.  
I think that concerns me.  	Don't make me order you.
Don't make me order you.	You going to drag me out and me in my room until I go to college?
Wait.	What?
A girl named Elizabeth Sherman was attacked by four drunken seniors.  	Attacked how?
Attacked how?	She was raped. At least that's what she claimed.
She was raped. At least that's what she claimed.	You didn't believe her?
You didn't believe her?	 She was in pretty bad shape Inside and out.  But the boys were never formally charged.  
 She was in pretty bad shape Inside and out.  But the boys were never formally charged.  	Why not?
Why not?	An angry girl that no one really liked.  She'd called them 'queers'.  
An angry girl that no one really liked.  She'd called them 'queers'.  	People thought these guys had a right to rape her because she called them 'queers'?
People thought these guys had a right to rape her because she called them 'queers'?	Things were different back then.  You think kids are sexually bottled up today. . . .  
How could you?	I guess I was kind of scared going against the gain.  Against the whole town.  
I guess I was kind of scared going against the gain.  Against the whole town.  	The word is Mob.
The word is Mob.	I've regretted it ever since. Never run with the herd just because they're the herd.
I've regretted it ever since. Never run with the herd just because they're the herd.	Who were they?
Who were they?	Who?
Who?	The men. Do any of them still live around here?
The men. Do any of them still live around here?	Two men left town right after it happened.
Two men left town right after it happened.	You're not telling me something.
You're not telling me something.	Mr. Sisler was one of them.
Mr. Sisler was one of them.	The principal?
The principal?	Yes.
Yes.	Who was the fourth?
Who was the fourth?	God. It's like everything that was ever repressed in this town is suddenly bubbling up through the ground.
God. It's like everything that was ever repressed in this town is suddenly bubbling up through the ground.	Dad?
Dad?	THAT'S why he called Mr. Sisler first. He was one of them.
Hello?	I'm looking for Lisa Sherman.
I'm looking for Lisa Sherman.	She's not here.
She's not here.	You know where I can find her?
You know where I can find her?	St. Michael's.
St. Michael's.	She works at a church?
She works at a church?	She resides there. Out back. She died a year and a half ago.
She resides there. Out back. She died a year and a half ago.	Of what?
Of what?	A bullet to the right cerebellum.
A bullet to the right cerebellum.	She was murdered?
She was murdered?	No. She ate a pistol for lunch one day.
No. She ate a pistol for lunch one day.	Can you describe her? How old was she?
Can you describe her? How old was she?	I never met the woman. I'm just taking care of the place until they sell it.
I never met the woman. I'm just taking care of the place until they sell it.	Can you get inside?
Can you get inside?	I can.
Is there a picture of her somewhere?	No pictures. No mirrors. Was she a crazy woman when you knew her?
No pictures. No mirrors. Was she a crazy woman when you knew her?	No.
No.	Couldn't tell she going to off herself, huh?
Couldn't tell she going to off herself, huh?	No, you couldn't.
No, you couldn't.	I've been in a lot of people's houses and this one's the creepiest.
I've been in a lot of people's houses and this one's the creepiest.	Really?
Really?	Yeah. You should check downstairs.
Yeah. You should check downstairs.	Why?
I know he lit cats on fire when he was a kid.  	My dad acts like he's Johnny Fucking Perfect and he's really Johnny Fucking Rapist.
My dad acts like he's Johnny Fucking Perfect and he's really Johnny Fucking Rapist.	They're even bigger hypocrites than your friends.  
They're even bigger hypocrites than your friends.  	I can't believe I listened to one word of his shit.
I can't believe I listened to one word of his shit.	But if he'd been sent to jail, there would be no Jody.
But if he'd been sent to jail, there would be no Jody.	So I should feel happy that he got away with it?
So I should feel happy that he got away with it?	I don't know. I kind of am.
I don't know. I kind of am.	Are you coming to the party?
What's wrong? Am I doing something wrong?	Just making me feel like a piece of meat.
Just making me feel like a piece of meat.	I'm making you feel like meat?
I'm making you feel like meat?	Yeah.
Yeah.	You break up with me because I won't fuck you.
You break up with me because I won't fuck you.	That's not why we broke up.
That's not why we broke up.	You flaunt some slut in my face.
You flaunt some slut in my face.	Sharon's far from a slut.
Sharon's far from a slut.	And when I finally agree to spread my legs, you accuse me of treating you like meat.
And when I finally agree to spread my legs, you accuse me of treating you like meat.	It doesn't have that much to do with me.  
It doesn't have that much to do with me.  	Please don't go. Please. Stay, We'll just talk. Then go to the party.
Please don't go. Please. Stay, We'll just talk. Then go to the party.	This party is sick.
This party is sick.	Jody. Wait.
Jody. Wait.	What?
What?	I'm scared. Three kids are dead. I want to go to this party.
I know where you're going.	You do?
You do?	Your brother told us.
Your brother told us.	Daddy....
Daddy....	Shh. I'm not going to tell you not to go.
Shh. I'm not going to tell you not to go.	You're not?
of COURSE. You're not scared?	Of course I'm scared.
Of course I'm scared.	Then you should go.
Then you should go.	You think I should go to the party, Mr. Marliston?
You think I should go to the party, Mr. Marliston?	I really do. For your own safety.
I really do. For your own safety.	I just feel so manipulated. By everyone. My dad, my boyfriend, and now some psychopath I don't even know.
I just feel so manipulated. By everyone. My dad, my boyfriend, and now some psychopath I don't even know.	The event that fatalistically shaped my life happened before I was even born.  
The event that fatalistically shaped my life happened before I was even born.  	Really?
Really?	Yes. We have no real freedom. You of all people should understand that. This may sting.
Yes. We have no real freedom. You of all people should understand that. This may sting.	Me? Why me?
Me? Why me?	Because of your father. The way what his sins shaped you.
Because of your father. The way what his sins shaped you.	What do you know about my father?
What do you know about my father?	He's a rapist. Like mine.
He's a rapist. Like mine.	_ Your father raped someone?
_ Your father raped someone?	Lisa Sherman was my mother. Do you know who that is?
Lisa Sherman was my mother. Do you know who that is?	Yes.
Yes.	 One of the four men who raped her is my father I have no idea which one.  
 One of the four men who raped her is my father I have no idea which one.  	You're the killed.
You're so beautiful.	So are you.
So are you.	Now don't be nervous.
One more time.	I get the imports.
My wallet's on the mantle when you've finished your rifling, Kenny.	Oh, hey Mr. Marliston. W-What's Jody's bike doing on your front porch?
Oh, hey Mr. Marliston. W-What's Jody's bike doing on your front porch?	That all depends Kenny. Depends on why the FUCK you've broken into your history teacher's house?
That all depends Kenny. Depends on why the FUCK you've broken into your history teacher's house?	Alright, Marliston, I know she's here.
My dad's down there!	He's dead! We've got to get the fuck out of here!
Go to the police station!	Deputy Webber's at the party. It's only three blocks away.
We just found another body.	Who's?
Who's?	Killer also chopped off his pecker and stuffed it in his pencil holder.  
Killer also chopped off his pecker and stuffed it in his pencil holder.  	Jesus. Any word from Brent?
Jesus. Any word from Brent?	It's turning into WOODSTOCK except there's no concert.  
It's turning into WOODSTOCK except there's no concert.  	 See where he is What he wants us to do.  I'll head over to the school.  
 See where he is What he wants us to do.  I'll head over to the school.  	Ok.
Ok.	Don't leave this party until you hear from me.
Don't leave this party until you hear from me.	But I shouldn't shut it down?
?  What the fuck happened to your face? 	Hey, look, Elvis.
Hey, look, Elvis.	Where?
Where?	You really are a god damn rube.
Where are the police?	Oh GOD IT'S HIM!
