Come on ...	Doctor Miles' office, may I help you?
D-E-A-D. Chelios... got it?	Yes sir...
I ... uhh ...	Yeah, yeah. You wanna know what I was doing?
. .  it may actually be the last thing I do, understand that ?  Copy me on that? 	Ricky Verona?
I'm talking! What are we talking about?	Don't fuck with me!!
Chevy ?  I believe you had a question, or some point you were trying to make? 	Where's Verona.
Where's Verona.	OK. I am not affiliated with Ricky Verona.
Thank you. That's what I'm talking about. That resembles civility.	One of the BROTHERS catches him, holds him up and shoves him away.  
OK, now you're insulting me.	Come on, man, I know you got coke.
Come on, man, I know you got coke.	You think every brother is carrying, is that it?
You think every brother is carrying, is that it?	Come on, I don't have time for this, just give me something ... I'm really dying here ...
Come on, I don't have time for this, just give me something ... I'm really dying here ...	I can see that.
I can see that.	. .  if I don't . . .  May I just have some coke, please? 
. .  if I don't . . .  May I just have some coke, please? 	So this is medicinal use coke, that's what you're telling me.
What do you know about it?	I know you pulled the trigger.
Whoa, Chelios. You good, man?	his shit's not working.
ey, what's up, Doc!	You motherfucker!
You motherfucker!	ude, aren't you dead yet? What the hell are you doing out there?
ude, aren't you dead yet? What the hell are you doing out there?	I'm coming for you, asshole, believe me.
I'm coming for you, asshole, believe me.	 I forgot to say so on that gay James Bond tape I left for you. . .  
lever. Snappy. Did you pretty good, didn't I, Chelios? Come on, you can admit it.	We'll see.
Well you don't have to be so damn cool about it.	What do you expect me to do?
Epi ... something ...	nephrin. Epi-nephrin.
nephrin. Epi-nephrin.	OK, OK. I gotta go.
Chev?	Yeah, what is it?
Chev?	Uh huh.
You're supposed to be dead!!!	Think you can get me some more? 
.  fuck you, man, shove that thing up your ass.  	Fucked up that you killed your own brother.  
My cart...	What?
What?	Asshole...!
Not going to tell you again.	Now juice me.
Chevy!	Yep.
Yep.	I'm in the air, man. Did you get the stuff I told you?
I'm in the air, man. Did you get the stuff I told you?	Got it.
Yep.	Oh boy. I said a fifth of a syringe, you idiot. Now you're dead for sure.
Oh boy. I said a fifth of a syringe, you idiot. Now you're dead for sure.	Right.
Right.	Chest is on fire.
Chest is on fire.	Check.
Check.	But you're cold.
But you're cold.	Check.
Check.	You got a steel hard on.
Maybe some weed ... I don't know ...	Check.
Check.	 look, I'll be in LA in twenty minutes.  I'll call you when I hit the ground.  
 look, I'll be in LA in twenty minutes.  I'll call you when I hit the ground.  	Copy.
Copy.	You're a good kid, Chev. Nice knowing you.
Is this your new look or something?	That's right. You into it?
That's right. You into it?	It's ... completely appalling. Very you, Chev.
Are you looking for my other boyfriend?	You haven't turned on the TV today, right?
You haven't turned on the TV today, right?	No. Why?
No. Why?	Didn't think so. Listen, we've got to get out of here.
Actually, I'm glad you're here. Can you change the clock on the microwave?	What?
That was just totally uncalled for.	I'm sorry ... look, can we just ...
Chev, you're scaring me.	Wait a minute. Do you trust me?
Wait a minute. Do you trust me?	No.
No.	Make love to me.
Make love to me.	What?
What?	Come on. I think it'll help.
Get off! Are you kidding me?	Take your clothes off.
Take your clothes off.	No!
You drink this Haitian shit, crackhead. This right here is some hardcore shit. Made from plant shit.	Nice.
What?	Don Carlos wants you off the street.
You weren't lying.	Welcome to my life.
Welcome to my life.	No, I mean: that you were going to give it all up for me.
No, I mean: that you were going to give it all up for me.	Oh. Yeah.
Oh. Yeah.	And the other part?
That's right.	And what are you prepared to give me. Asshole.
You never call, you never write... I haven't seen you since you ran out at	. .  why wouldn't I stick around for entertainment like that? 
You was that, maybe. But there's a new gun in town.	Don't tell me you're talking about your bro, Def Lepard.
Don't tell me you're talking about your bro, Def Lepard.	He did you pretty good, didn't he?
He did you pretty good, didn't he?	 I don't get it - why didn't you guys just cut me up alive when you had the chance? 
