Got my money?	What? I... How long have I been here?
What is your name... What is your name...	Hey!
Dammit!	Sorry, sir.
Sorry, sir.	Don�t ever sneak up on me like that! Who are you?
Don�t ever sneak up on me like that! Who are you?	Patricia Crenshaw.
Patricia Crenshaw.	I�m your new assistant.
I�m your new assistant.	I didn�t requisition a secretary.
I didn�t requisition a secretary.	The Chief-Inspector thought you might need a hand.
The Chief-Inspector thought you might need a hand.	 They found several more traps and things were filed under pretty strange categories. .  Poor man.  
 They found several more traps and things were filed under pretty strange categories. .  Poor man.  	Good.
Good.	You won�t regret this, sir.
Okay. Newspapers.	Are you alright?
How can I submit this?	I�m sorry...
I�m sorry...	Do you wash your hands before you type things?
Do you wash your hands before you type things?	Why, yes.
Sell maps?	What of?
What of?	The city. I need to get to the ocean.
The city. I need to get to the ocean.	Nope. No maps. Ocean, huh? On vacation?
Nope. No maps. Ocean, huh? On vacation?	Grandpa thought customers might like some mood music.
Grandpa thought customers might like some mood music.	You still look familiar. It�s driving me nuts! Sure I don�t know ya from somewhere?
Beware! The night is deadly. There is a criminal among us.	It could be she! The innocent across the street!
It could be she! The innocent across the street!	Or the temptress next door!
Or the temptress next door!	Or mister nervy stranger at the back!
Or mister nervy stranger at the back!	You are thinking it could be anyone? And you�re right! Why, it could even be Mother!
How long have you been here?	Maybe ten minutes... That�s strange.
Maybe ten minutes... That�s strange.	Spinning backwards?
Spinning backwards?	Yours too?
You remember nothing? Who you are? What you've done?	You know something about me?
You think I haven't been trying! It's like there was never anything there. (pauses) Just water.	Water?
Water?	Waves... A beach. A woman whispering. That's all. I need to stay awake. Do you have any pills?
Waves... A beach. A woman whispering. That's all. I need to stay awake. Do you have any pills?	What does she say? The woman.
Your name is John White.	That's what people keep telling me.
That's what people keep telling me.	Bad dreams?
Bad dreams?	Yes.
Yes.	Tell me about them...
Tell me about them...	If you like.
If you like.	You're supposed to be my doctor, right?
Known me for long?	Well...
Well...	I cannot say... You don't know the answer to that?
I cannot say... You don't know the answer to that?	I told you, I can't remember a thing!
. .  	Did she drown? The woman you told me about?
Did she drown? The woman you told me about?	Not exactly. She was found in a canal, disembowelled. Throat cut. Blood drained. The body wrapped in a bed-sheet.
Not exactly. She was found in a canal, disembowelled. Throat cut. Blood drained. The body wrapped in a bed-sheet.	Horrible...
Horrible...	You remember nothing, eh? Let me show you something.
Without a past we are nothing.  This is why you are so interesting.  	I'm nothing then.
It feels no pain.	Can I get my life back?
Can I get my life back?	Maybe.
Maybe.	We know of two kinds of memory. Firstly, declarative memory.
We know of two kinds of memory. Firstly, declarative memory.	And then there is procedural memory.
And then there is procedural memory.	Follow?
Follow?	I am building an experiment with hamsters next.  Cute little things.  
I'm sorry. About before.	You must be patient though.  Trust me completely.  I'm here to help.  
You must be patient though.  Trust me completely.  I'm here to help.  	It can't wait?
Leave it!	Damn! Whoever it is - get rid of them!
Damn! Whoever it is - get rid of them!	Keys.
Hold it!	Police. Nobody move.
Police. Nobody move.	He tried to kill me!
He tried to kill me!	Shut up! Everybody stay calm...
Left - profile.	Right - profile.
Right - profile.	Move - forward.
Move - forward.	Move - forward.
Move - forward.	Watch - the - wheel.
Watch - the - wheel.	Move - forward.
Move - forward.	Stand - behind - the - screen.
Stand - behind - the - screen.	Move - forward.
The men in black - they're the killers.	You're a liar!
You're a liar!	No, it's the truth.
If you would only take this, inject it in your brain, everything would be much clearer.	Not that again...
Not that again...	Everyone get's one - very much like this... But this one's special. It will help you understand, everything...
Everyone get's one - very much like this... But this one's special. It will help you understand, everything...	You have been left - blank.  
You've been working too hard.	Please! Don't be foolish! Time is short. Let me show you something. Look at this syringe.
Please! Don't be foolish! Time is short. Let me show you something. Look at this syringe.	Why?
Why?	Don't ask stupid questions. Look at it.
That's me. I'm a shadow.	Do I look like a murderer to you?
. .  Like you're telling me about somebody else's life. . .  	It's the truth... I need you. I know you're innocent.
It's the truth... I need you. I know you're innocent.	How do you know I'm innocent?
How do you know I'm innocent?	Come home with me - maybe things will make sense then. . .  
Come home with me - maybe things will make sense then. . .  	I can't do that. It's dangerous. What about my parents? Do you know where I can find them?
I can't do that. It's dangerous. What about my parents? Do you know where I can find them?	They're dead, John.
They're dead, John.	You have an uncle. You were very close.
You have an uncle. You were very close.	This is where he lives. I'm sure he would like to see you.
Pull up some garbage - make yourself at home.	They've taken my mind, my memories...
They've taken my mind, my memories...	What? Who has?
What? Who has?	Is that your idea of a joke? I don't remember... Take my advice, Bumstead. Get off this case. Now.
Get away! Leave me alone!	It's - it's disgusting, I know...
It's - it's disgusting, I know...	Jesus! We have to get you to a doctor...
Jesus! We have to get you to a doctor...	No... No doctor...
No... No doctor...	But... How long has this been happening?
Who is it?	Won't say. Says he must talk to you.
Won't say. Says he must talk to you.	Put it through...
Why give yourself up?	I - ah - couldn't think of anything else to do. I thought maybe you know something... I'm scared.
I - ah - couldn't think of anything else to do. I thought maybe you know something... I'm scared.	That was a pretty good escape act at the station. How did you do that?
That was a pretty good escape act at the station. How did you do that?	I woke up in a subway. I don't know how I got there.
I woke up in a subway. I don't know how I got there.	People... after me.
People... after me.	Who?
Who?	I don't know who they are.
I don't know who they are.	Why are they after you?
Why are they after you?	Don't know that either.
I hear a clock in my head, and I like it!	A world in our likeness!
That stuff helpful?	What do you know about these men in black? 
What do you know about these men in black? 	They're not people - like us - got insects in their heads. . .  Got any disinfectant? 
They're not people - like us - got insects in their heads. . .  Got any disinfectant? 	Here. Careful with your trousers. That stuff stains.
Here. Careful with your trousers. That stuff stains.	Here.
Here.	Any idea what part the Doctor plays in this business?
Couldn't remember for the life of me what they looked like, then I understood why. . .  	They didn't have faces.
They didn't have faces.	What?
What?	Sit down in a comfortable chair. . .  And study each detail of this subject.  
Sit down in a comfortable chair. . .  And study each detail of this subject.  	Everything was liquid beneath a thin surface that had always seemed solid to me...
Everything was liquid beneath a thin surface that had always seemed solid to me...	Is there anything you haven't told me about this business? Even the most insignificant thing?
Is there anything you haven't told me about this business? Even the most insignificant thing?	Go on.
Go on.	The point is no one seems to know how to get there.  
The point is no one seems to know how to get there.  	Why, that's ridiculous. You just...
Was that for real down there?	I'm afraid so.
What now?	I need to go back to the station.  Where will you be? 
I need to go back to the station.  Where will you be? 	I'll go see an uncle of mine. Five - one - eight - three - double six - three...
Yeah. That's what I said! What..?	I'm looking for this address.
Look! This is a good one!	What is that door?
What is that door?	Which one?
Which one?	There. Behind the cabinet. Where does it go?
There. Behind the cabinet. Where does it go?	Such a joker! Like your father.
Such a joker! Like your father.	No. Have a look.
No. Have a look.	You see it?
You see it?	Yes.
Yes.	Where does it lead?
Where does it lead?	It must be a closet or something.
I can't wait any longer...	I'm sorry. I told you, she is being examined...
What is it?	We are... living in their dreams...
Before I pronounce sentence...	How dare you use your tricks on me!
How dare you use your tricks on me!	I didn't realise...
I didn't realise...	Shut up, freak! Monster! You are insignificant.
Yes...	What's your name?
