You met any of those old stars?	What did you say your name was? 
What did you say your name was? 	Ted.
Ted.	Errol Flynn used to call me "Alibi. " You'll pick up a few stories yourself, kid.  
Errol Flynn used to call me "Alibi. " You'll pick up a few stories yourself, kid.  	I don't think so, not like yours.
I don't think so, not like yours.	What do you think a star does when he goes to the bathroom, kid?
What do you think a star does when he goes to the bathroom, kid?	Beats me.
Beats me.	He pulls his pants down and takes a crap just like you and me. Take my word for it.
He pulls his pants down and takes a crap just like you and me. Take my word for it.	Camacho!
Camacho!	Who?
Who?	It's tough not to get a little personal in this business.  
It's tough not to get a little personal in this business.  	What do you mean?
What do you mean?	Put it on.
Put it on.	I can't believe I wore that thing for fifty years.  You keep it.  
I can't believe I wore that thing for fifty years.  You keep it.  	Stay away from night clerks, kids, hookers, and marital disputes.
Stay away from night clerks, kids, hookers, and marital disputes.	Never have sex with the clientele.
Never have sex with the clientele.	No way, not me. You got any other advice.
Sam! Hey, Sam, wait a minute!	What?
What?	I just want to say good-bye.
I just want to say good-bye.	Who are you?
Who are you?	Uhhh, Betty. The concierge. Your boss.
Uhhh, Betty. The concierge. Your boss.	Oh yeah. Gotta light, sister? Goddam cigar went out.
After fifty years, Sam retires, and you're taking over the night shift.	Correct.
Correct.	You're filling some mighty big shoes.
You're filling some mighty big shoes.	Oh, I know.
Oh, I know.	Sam was a legend in the hotel business.
Sam was a legend in the hotel business.	Oh, I know...
Oh, I know...	A bellhop's bellhop.
A bellhop's bellhop.	An inspiration to us all.
An inspiration to us all.	He ran the night desk for fifty years, all by himself.
He ran the night desk for fifty years, all by himself.	An amazing man.
An amazing man.	No desk clerk. No night man. No help. Just fuckin' Sam, and his wits.
No desk clerk. No night man. No help. Just fuckin' Sam, and his wits.	A man alone.
A man alone.	And you're gonna do the same.
And you're gonna do the same.	I know.
I know.	Tonight.
Tonight.	Tonight!
Tonight!	Yes, tonight.
Yes, tonight.	I can't.
I can't.	Yes, you can.
We were supposed to work it together.	I know, but I can't.
I know, but I can't.	Why not?
Why not?	I'm having a New Year's Eve party.
I'm having a New Year's Eve party.	Since when?
Since when?	And there's this guy.  German guy.  He's gonna be there.  And so am I.  
And there's this guy.  German guy.  He's gonna be there.  And so am I.  	I can't run this place by myself.
I can't run this place by myself.	Oh, sure ya can.
Oh, sure ya can.	No, I can't.
No, I can't.	Sam ran this place by himself for fifty years.
Ted, the night's cake. It's easy. The day's when it's busy. During the night there's nothing to do.	It's New Year's Eve.
It's New Year's Eve.	?  Unless you sell turkeys, business is dead You just got butterflies, that's all.  
?  Unless you sell turkeys, business is dead You just got butterflies, that's all.  	What I have ain't butterflies. I can't handle this hotel all by myself.
Okay... okay... okay... I'm calm, I'm cool, let's talk.	The only variable is Chester Rush in the penthouse.  
The only variable is Chester Rush in the penthouse.  	Chester Rush? The guy from The Wacky Detective?
Chester Rush? The guy from The Wacky Detective?	Ya never know about movie stars.  I'm tellin' ya, Ted, it's cake.  
Ya never know about movie stars.  I'm tellin' ya, Ted, it's cake.  	And look, if you have any problems, call me at the party.
Fifty bucks!	You're shirking your duties for this Nazi. For that you pay a price, and the price is fifty bucks.
You're shirking your duties for this Nazi. For that you pay a price, and the price is fifty bucks.	You're taking advantage of the situation.  Twenty bucks.  Now, twenty bucks is a fair price.  
You're taking advantage of the situation.  Twenty bucks.  Now, twenty bucks is a fair price.  	So fifty bucks is the perfect price.  
So fifty bucks is the perfect price.  	In fact, for fifty bucks, you better not call me unless the fuckin' building's burning down.  
Green? Is that bad? Like you read auras or something like that?	Something like that.
Something like that.	Yeah, well what color are you seein' around me... how's the tip lookin?
Yeah, well what color are you seein' around me... how's the tip lookin?	I see purple... in your face, and...
I will only need to stay till sunrise.	Okay... and how will you be paying?
Right.	What the hell you got in here, lady? Nuclear weapons?
What the hell you got in here, lady? Nuclear weapons?	The White Cliffs of Dover.
You're not my mother!	Yes I am.
Flea powder. One of the others is bringing her cat.	You're gonna have to wait in the other room.
You're gonna have to wait in the other room.	Why?
Why?	Because I said so.
Because I said so.	I'll watch TV.
I'll watch TV.	You can't watch TV because the noise will interfere with our ritual.
Kiva... you know what I love about you?	Your sweet side.
Your sweet side.	And what do I get if I'm sweet?
And what do I get if I'm sweet?	You get whatever you want. And you know what else I love about you?
You get whatever you want. And you know what else I love about you?	What?
What?	Your nose.
Wait. We do need a few things.	We need fresh rosemary from the kitchen. Mostly what we need is from the kitchen. Hey, are you listening?
Don't put me in there by myself. I'll miss you way too much.	Kiva, don't do this to me.
Kiva, don't do this to me.	. .  you know what I mean. . .  remember. . . ? 
. .  you know what I mean. . .  remember. . . ? 	. .  the way you want it. . .  with the egg whites and the kilt.  
. .  the way you want it. . .  with the egg whites and the kilt.  	You mean... like last week?
You mean... like last week?	We'll talk about this later, Kiva.
Help me out, lady. I gotta earn this fifty bucks!	Oh look, they don't care if I smile or not! All they want is...
Oh look, they don't care if I smile or not! All they want is...	You won't understand, believe me.
Ha, like a coven of witches?	Yes.
Yes.	Oh.
Oh.	I knew that!
While our dear goddess: a stone in her honeymoon bed.  	This was Diana.
This was Diana.	This girl here? This is the goddess Diana?
This girl here? This is the goddess Diana?	I hate to tell you this, but I kinda doubt she was a virgin.
I hate to tell you this, but I kinda doubt she was a virgin.	 Which is the example I've tried to follow: to do everything but that till I marry. .  
 Which is the example I've tried to follow: to do everything but that till I marry. .  	If you say she was a virgin, I'll believe it.  
If this is gonna be like one of those afterbirth conversations, I don't think I wanna hear this.	Only... I swallowed it...
Only... I swallowed it...	You swallowed what?
You swallowed what?	You mean, you were supposed to bring... like... like a guy's... and you...?
Ha, c'mon now, joke's over. Hey, we're gonna step in the flea powder.	That's not flea powder, that's sacred dust ground from the horns of Albino goats.
That's not flea powder, that's sacred dust ground from the horns of Albino goats.	Right! I knew that!
Right! I knew that!	What's a nice girl like you doing in a coven, anyway?
What's a nice girl like you doing in a coven, anyway?	I've attended four births already !  I can prevent vaginal tears and everything.  
I've attended four births already !  I can prevent vaginal tears and everything.  	Well, that's a good thing! A guy doesn't like surprises down there.
Well, that's a good thing! A guy doesn't like surprises down there.	!  
!  	Oh, well, I see you've been gaining a lot of insight into your... girl powers...
Oh, well, I see you've been gaining a lot of insight into your... girl powers...	Do you really think so?
No. My boss.	Oh good!
Theodore? What do you take me for, Theodore?	A very upset man?
A very upset man?	I am an upset man, Theodore.
I am an upset man, Theodore.	How do you know my name, sir?
How do you know my name, sir?	I'm psychic, Theodore.
Okay.	So apologize!
So apologize!	For what?
For what?	You are really beginning to annoy me, Theodore.
You are really beginning to annoy me, Theodore.	Look, obviously you two are working something out and if I could help you with your problem I would.
Look, obviously you two are working something out and if I could help you with your problem I would.	Are you trying to say I don't give her what she needs ?  That I'm FUCKING INSENSITIVE !  !  
Are you trying to say I don't give her what she needs ?  That I'm FUCKING INSENSITIVE !  !  	Look, is this about another man? Or something?
Look, is this about another man? Or something?	Let's get our ABC's right, here, Theodore. Theodore, right?
Let's get our ABC's right, here, Theodore. Theodore, right?	Ted's better.
Ted's better.	Ted, okay... Are you saying my wife cheats on me?
Ted, okay... Are you saying my wife cheats on me?	I didn't say that... I...
I didn't say that... I...	I demand an apology !  
I demand an apology !  	Don't move. I've got to take this.
Don't move. I've got to take this.	What? (pause) We ain't got any needles here, kid. Just a big fucking gun.
What? (pause) We ain't got any needles here, kid. Just a big fucking gun.	Now, where was I? Oh yeah, I remember.
Now, where was I? Oh yeah, I remember.	I want you to pray for forgiveness, Theodore.
I want you to pray for forgiveness, Theodore.	Now say after me, "I apologize..."
Now say after me, "I apologize..."	I apologize...
I apologize...	For what?
For what?	For fucking what?
For fucking what?	That I said you might have been unfaithful?
That I said you might have been unfaithful?	 Say the following, "I, Theodore, must humbly and sincerely apologize for saying that you fucked another man ! " 
 Say the following, "I, Theodore, must humbly and sincerely apologize for saying that you fucked another man ! " 	Satisfied?
Satisfied?	Do you accept the fucking apology?
Do you accept the fucking apology?	?  I give and I give and I get nothing back 
?  I give and I give and I get nothing back 	She just sits there waiting for me to jump through hoops...
She just sits there waiting for me to jump through hoops...	Never let that happen to you, Theodore.  It makes you feel very little indeed.  
Never let that happen to you, Theodore.  It makes you feel very little indeed.  	You mind if I...?
You mind if I...?	Go ahead. Spit it out.
Go ahead. Spit it out.	I don't mean to upset you further, sir, but I think she was trying to say yes.
I don't mean to upset you further, sir, but I think she was trying to say yes.	Are you condescending to me, Theodore?
Are you condescending to me, Theodore?	Absolutely not, I would never do that.
Absolutely not, I would never do that.	Why don't you just say it?
Why don't you just say it?	Say what?
Say what?	That you think I'm an idiot.
That you think I'm an idiot.	I would never say that.
I would never say that.	?  You don't think I notice there is a gag in the woman's mouth 
?  You don't think I notice there is a gag in the woman's mouth 	Of course you do.
Of course you do.	Naturally "of course." And do you know how I know that?
Naturally "of course." And do you know how I know that?	How, sir?
What!	We don't have time to play charades here, asshole! Untie me quick.
But I've never seen you people before, we're complete strangers.	Everyone starts out strangers, Ted, it's where we end up that counts. Hurry up.
Everyone starts out strangers, Ted, it's where we end up that counts. Hurry up.	I don't know if I can do this. It's too hard.
I don't know if I can do this. It's too hard.	Life is hard, Ted. You ever stopped to consider how many times you change your underwear in a lifetime?
Life is hard, Ted. You ever stopped to consider how many times you change your underwear in a lifetime?	I don't mean literally, you ignoramus.
I don't mean literally, you ignoramus.	What?
What?	Forget it, listen to me. There's a gun in my suitcase behind the bed, it's loaded...
Forget it, listen to me. There's a gun in my suitcase behind the bed, it's loaded...	I'm not going to shoot anybody.
I'm not going to shoot anybody.	Fine. Get the gun and I'll shoot "anybody."
Fine. Get the gun and I'll shoot "anybody."	And make me an accessory in the murder of your husband?
And make me an accessory in the murder of your husband?	That's not fair. It just isn't fair.
So why's he got you tied up?	I'm a werewolf, Ted! Get the gun!
I'm a werewolf, Ted! Get the gun!	You can do it.  Come on, Ted.  You look like a good guy.  
You can do it.  Come on, Ted.  You look like a good guy.  	That's it, Teddy. You look so much more attractive when you're self- assured.
That's it, Teddy. You look so much more attractive when you're self- assured.	Quick, he's coming back. Put the gag back in, and remember the gun!
Okay. These are the rules. Don't break the rules and I won't break your necks.	I always wanted to say that. Someone said that to me when I was a kid.
I always wanted to say that. Someone said that to me when I was a kid.	Except they were joking. I'm not.
Except they were joking. I'm not.	If there's an emergency, call me on the phone, like your dad said.  
If there's an emergency, call me on the phone, like your dad said.  	That's not what he said.
That's not what he said.	He said to call if we need anything.
Your feet stink.	They don't stink.
They don't stink.	Check it out. T & A.
Check it out. T & A.	Change it. You're not supposed to watch this.
Change it. You're not supposed to watch this.	We're supposed to watch TV.
Ted? Hi. It's me, Sarah. You're our sitter for tonight.	Now, do you want them or do you not? 
Now, do you want them or do you not? 	I want you to turn off the Nudie station in our room.
I want you to turn off the Nudie station in our room.	I can't turn on an adult station without permission from your parents.
I can't turn on an adult station without permission from your parents.	No. Not turn it on, turn it off. It's already on.
No. Not turn it on, turn it off. It's already on.	That's not what the machine tells me.
That's not what the machine tells me.	There's naked ladies dancing on my TV and I want 'em off.  
Change the channel, now!	Man, you're the one with the stinky feet.
Man, you're the one with the stinky feet.	They don't stink.
They don't stink.	Yeah, they do.
Yeah, they do.	Here, smell for yourself.
Here, smell for yourself.	Go ahead.
Don't shake it! Ted? Hi. It's me. Sarah.	Yeah. Who died? No one? Then don't call me.
Yeah. Who died? No one? Then don't call me.	There's all kinds of leftover stuff around here.  
Are you watching TV?	Yep. If you wanna watch too, you have to go wash your face.
What the fuck is going on??!!	Your parents are on their way up and I'm not taking responsibility for this mess!
Your parents are on their way up and I'm not taking responsibility for this mess!	Check under the mattress!
Check under the mattress!	For what?
For what?	For the body, can't you smell it?
For the body, can't you smell it?	It's your feet!
It's your feet!	Jesus fucking Christ! What the fuck is this?
Jesus fucking Christ! What the fuck is this?	!  
!  	Don't call her that...
Don't call her that...	I'm dead fucking serious, there's a dead fucking Whore stuffed in the bedsprings of the fucking bed!
Let me speak to Betty.	Party's over, she probably went home.
Party's over, she probably went home.	She lives there.
She lives there.	Oh, well, I haven't seen 'em in a while.
Oh, well, I haven't seen 'em in a while.	Do you even know who I'm talking about?
Do you even know who I'm talking about?	Yeah... yeah... yeah... I know 'em, I know Eddy.
Yeah... yeah... yeah... I know 'em, I know Eddy.	Betty, not Eddy.
Betty, not Eddy.	Yeah... yeah... I know Betty too... Tall...
Yeah... yeah... I know Betty too... Tall...	No, not particularly. She's got curly red hair.
No, not particularly. She's got curly red hair.	No, no, no, no, no, I know, I know. Japanese girl.
No, no, no, no, no, I know, I know. Japanese girl.	She's not Japanese! I just said she had red hair.
She's not Japanese! I just said she had red hair.	Yeah... yeah... yeah... I know her.
?  Is that like at the circus when they stick all those clowns in an itty- bitty car? 	A coven. A coven of witches. Well, one witch in particular.
A coven. A coven of witches. Well, one witch in particular.	Was she an old hag with a mole, with hair growing out of it?
Was she an old hag with a mole, with hair growing out of it?	No-no-no, she was... quite beautiful.
No-no-no, she was... quite beautiful.	Ted?
Ted?	Yes.
Yes.	What's the problem?
What's the problem?	But it was still an unnerving way to start off the night.  
But it was still an unnerving way to start off the night.  	Sounds to me like a pretty great way to start off the night.
He made you have psycho sex with his wife?	!  He held me at gunpoint with a loaded gun !  
!  He held me at gunpoint with a loaded gun !  	What kinda gun?
What kinda gun?	I don't know, I'm not a gun guy. It was big.
I don't know, I'm not a gun guy. It was big.	Like Dirty Harry's gun.
Like Dirty Harry's gun.	Yeah, something like that.
Yeah, something like that.	Did it have a real long barrel or a short barrel?
Is that the penthouse?	Yeah.
Yeah.	That's the Chester Rush party, they want something.
Yes, I did.	You said the hotel was on fire.  Is it still on fire? 
You said the hotel was on fire.  Is it still on fire? 	No, it's out.
?  Please just take care of him, the entire staff of the Mon Signor is begging you !  	Okay. But get your ass here pronto.
Okay. But get your ass here pronto.	You're a good man, Ted. Thanks.
No, thank you.	Ya sure? Cristal. It's the best. I never liked champagne before I had Cristal, now I love it.
