What makes the world go around?	...you tell me.
...you tell me.	Gold.
Gold.	Some people say Love.
Some people say Love.	It is love. It is Love of Gold.
It is love. It is Love of Gold.	...easy to get the gold, hard to get it home.
I won her in a raffle...	No, I'm serious. What's a girl like hh...
No, I'm serious. What's a girl like hh...	She's got this "father" thing. You like the boat?
She's got this "father" thing. You like the boat?	Waal... your price is rather high...
Waal... your price is rather high...	I'll tell you what, then why'nt you go build one...
...I like this boat...	...Mister Fletcher, tell you what, you put down your deposit, we're gonna fit you one out. Your specs.
...Mister Fletcher, tell you what, you put down your deposit, we're gonna fit you one out. Your specs.	This is a hell of a boat.  
What do you want me to bring you back?	You just come back... Stay in the shadows.
You just come back... Stay in the shadows.	Everybody's lookin' in the shadows.
You shouldn't sneak up on a fella like that.	...what's he likely to do...?
Where you goin to go with the gelt?	You know where I'm going. Me and the girl, gone get on the boat.
You know where I'm going. Me and the girl, gone get on the boat.	You gone go South somewhere... rub yourselves all over, Cocoa butter...
You gone go South somewhere... rub yourselves all over, Cocoa butter...	...that's right.
...that's right.	Get one of them cocker spaniel dogs, pull down your bathingsuit...
Get one of them cocker spaniel dogs, pull down your bathingsuit...	...that's right...
...that's right...	...stick your white ass out at the world...
No, you're the Boss Hog, Joe.	Kind of you to say so.
Kind of you to say so.	Nobody... gets the goods like you...
Nobody... gets the goods like you...	Anybody can get the goods, the tough part's, getting away.
Plan a good enough getaway, you could steal Ebbetts Field.	Ebbet's Field's gone...
And half of that's yours. You n'your team.	Yeah, why're you telling me that?
Yeah, why're you telling me that?	...I told you we're on for the "other" thing? The Swiss thing?
...the other thing?	...you remember that?
Look here, Pal... Look here, Pal... You're the help...	I'm what...?
I'm what...?	...you're...
. .  	I got to go.
You trine to play us for, you over-the-hill, short-weight motherfucker...	...I don't think your friend likes me...
...you'll do the Swiss Job?	No.
No.	Well, then, it's not alright. What are you telling me...?
I'm sorry...	...what do you tell me? What is it you tell me?
...what do you tell me? What is it you tell me?	What is it I tell you?
What is it I tell you?	"Any situation, stand it on its head."
"Any situation, stand it on its head."	Izzat right...
For cash?	That's the sweetener.
You say "cash," he knows we're hungry. He'll counter ten, twenny percent less, you kick around, and accept it.	Where's he gonna get the cash at night?
Where's he gonna get the cash at night?	Let him get it tomorrow. You bring him the title for the boat.
...I'll meet you in Mexico.	How're you going to Mexico...?
Well, would you tell him...	...I can't go down there with nothing...
You know, in many ways, it isn't their arrogance that hurts, it's the money.	Yeah? What were you gonna do with the money?
...with what?	Well, what about Times Two. If they stiffed him on Monday, what're they gonna do on Wednesday...
...may it be so.	...and a back-up plan...
Alright.	You'll do the job?
You'll do the job?	That's right.
That's right.	I'm sorry I put you in a position.
I'm sorry I put you in a position.	It's very sporting of you to say so.
It's very sporting of you to say so.	Well...
...you're ahead of me every turn. How about that.	...stunning.
...stunning.	...the date holds, you got the shipment on the fourteenth.
...I'm sorry for what I said.	...what'd he say...?
You going to take that lame onna job?	I'll tell you what, you make the decisions, and I'll bitch at you. It's Fun to Play Pretend!
I'll tell you what, you make the decisions, and I'll bitch at you. It's Fun to Play Pretend!	It's another thing, put your head in the Lion's Mouth and shoot yourself.  I. . .  
Zat so?	Time was, you wuun't of asked him.
Time was, you wuun't of asked him.	Yeah, well, the time was I was the Law West of the Pecos.
Yeah, well, the time was I was the Law West of the Pecos.	And now...?
He'd never go soft on you, Joey...	Well, then. What's the thing? Am I missing something...?
I got to Bobby...	I know you do.
I know you do.	Tick tock.
Tick tock.	No, I know.
But everybody gets his cut from the Jewelry store.	Yeah, thanks, but after which, what're you going to live on?
...he's okay.	Yeah, well, you know, that was his road game.
Yeah, well, you know, that was his road game.	He's too old for that.
Can he do the thing?	He was doing the thing before you were born.
I got to redo some of these figures.	They worked out on the plan, why all a sudden now, you...
...what...?	D'you ever do that?
D'you ever do that?	Yeah.
I found a Hotwalker for him.	...Fran...?
...Fran...?	Well, it could be...
Well, it could be...	I don't mean to 'pry'
...keep it together... keep it together...	...can he cool the guy out...
...can he cool the guy out...	Just pick up your clipboard, and make like you're writing in it.
The thing of it is, the thing of it is, it's a question of redistribution...	How's that?
How's that?	The question: how do we get the money from there to here... it's just a question in logistics.
The question: how do we get the money from there to here... it's just a question in logistics.	"What is the robbing of a bank, compared with the founding of a bank?"
"What is the robbing of a bank, compared with the founding of a bank?"	Who said that?
Well, it's always the pretty girl stays home, innit?	Izzat what they said in the White Community...?
Izzat what they said in the White Community...?	That's what I hear.
I'm very resilient.	Yeah, so's Gumby.
...din we check'em?	I know we checked'em. What I'm doing, I'm. I'm asking you a question.
I know we checked'em. What I'm doing, I'm. I'm asking you a question.	What happened to Check It an Forget it?
Why would you put a man in a position, he's got no way out?	What is that, your philosophy?
What is that, your philosophy?	That's right.
That's right.	...what is it to you?
...what is it to you?	...he's my Husband.
You gonna miss it?	What?
What?	Your boat?
Your boat?	Well, it's a nice boat.
Well, it's a nice boat.	Hey, baby, after this job, you're gone have enough money, make this look like a Boat inna Bathtub.
...they found the car.	...what car?
...what car?	...the car we used at the Overpass. The cops found it, I heard it on the police band.
...the car we used at the Overpass. The cops found it, I heard it on the police band.	...they found it, how'd they find it? I tole you to it? I tole you to ditch it in...
The job stands...	...I'm sorry, Joe.
Joe. Joey, I...	Get him out of here.
Joe. Joe, I swear to God. I swear to God, I... are they gone...?	They're gone.
They're gone.	Well, then, you get gone, too.
You gonna be Okay?	I'm okay now.
I'm okay now.	Yeah? What do you do for cash?
Yeah? What do you do for cash?	...we're taking down the Boat guy.
...we're taking down the Boat guy.	You're taking down the boat guy...
You're taking down the boat guy...	That's right.
It's enough, get us away...	And then Aloha.
The Swiss job.  At's a beautiful plan.  	So was World War One.
So was World War One.	...no, it's a beautiful plan, Joe. You're the maestro.
...no, it's a beautiful plan, Joe. You're the maestro.	Yeah, well, it's all in a lifetime...
Yeah, well, it's all in a lifetime...	Izzat so?
See you, Joe.	I'll send you a Papaya.
I'll send you a Papaya.	They're good for digestion.
They're good for digestion.	Say good-bye to your niece.
Say good-bye to your niece.	Cute, huh?
I would of done that.	No, I'm the Frontier Wife.
No, I'm the Frontier Wife.	...that's right...
...that's right...	You ready to go?
You'll miss the guys.	Buncha Old Men, talkin' about Old Touches...
Buncha Old Men, talkin' about Old Touches...	...that's right...
...that's right...	Cuttin up Old Touches, th'time So and So overslept. You know what...?
You did, Baby...	Well. Help me remember it, huh...?
You know, we're goin' down there with nothing...	We'll get the boat money...
We'll get the boat money...	...yeah?
...yeah?	That's enough to start over.
That's enough to start over.	Is it enough for you...?
South we go, Baby.	...that's right.
...that's right.	You set to walk away from it?
You set to walk away from it?	Hey, I got you, what do I care...?
Hey, I got you, what do I care...?	Hello Mr...
Hello... Hello...?	...try him back...
Din't you just make yourself dispensable?	Can you shoot me and walk away from it ?  You know they'll kill you.  
Can you shoot me and walk away from it ?  You know they'll kill you.  	You my self-help program...?
You my self-help program...?	You gone shoot me, go on the run, with nothing? With that pretty little thing?
You gone shoot me, go on the run, with nothing? With that pretty little thing?	That would be my wife.
That would be my wife.	Is that so?
Is that so?	That's correct.
Your turn. . .  	Joe, leave him...
Joe, leave him...	Eh? Cat got your tongue? You wanna make peace.
Eh? Cat got your tongue? You wanna make peace.	...Joe
Get up.	What're you gonna do.
What you doin here?	Well, you know, I'm with my friends...
Well, you know, I'm with my friends...	I don't see nobody else here...
Baby, you shuunt be on the streets, the first place...	...what's the move...?
What're we forgetting...?	How did we get away with the Gold?
Robert the Bruce. Watched this Spider, try, three hours, to spin this web...	Uh huh...
Uh huh...	Til finally...
Til finally...	Yeah?
...yes.	He put her up, to come to you.
Well, no, but as Rational Men, don't we have to "doubt" her?	She thinks the guy's weak, he's scared, she's scared, I think she's sincere.
...get me the name of a freight forwarder.	...what?
...and how's he getting his share away...?	...what difference, you're going to screw it out of him anyway...
...tucking Betty Croft in...	What's she, out all night partying...?
I'm fine...	Sometimes, th'drenaline, hits you, gives you the shakes...
Sometimes, th'drenaline, hits you, gives you the shakes...	I'm alright.
...you think so...?	And we used to mock him.  But that bible stopped a bullet.  
And we used to mock him.  But that bible stopped a bullet.  	No shit.
...up early or up late.	Not up at all, till I get that down...
Not up at all, till I get that down...	I heard that.
I heard that.	?  They lett'n you play all  ?  They lett'n you play all by yourself? 
?  They lett'n you play all  ?  They lett'n you play all by yourself? 	Na, she's got this stomach thing. Least little...
Na, she's got this stomach thing. Least little...	Uh huh...
...who's been through here...?	Well I. I can tell you who's...
Don't look back... don't look back...	How's he... how is he...?
Where's my diversion...?	I... I threw it in the garb... Joe: Joe, Listen:
I... I threw it in the garb... Joe: Joe, Listen:	Where's my explosion, I'm up here naked...
...they got your photo...?	Yeah, well, that's a Hazard of the jjj...
Yeah, well, that's a Hazard of the jjj...	You can't go through the roadblock if...
You can't go through the roadblock if...	I told you on the day, they had me, you...
I told you on the day, they had me, you...	Yeah, but you... I can't have you going through the...
They got you on film, you got to go. You'll never make the road block... Joe...	I got to go with the gold.
Yeah, that's about as close as I ever want it to be...	...why did you have to hurt him...?
. .  you know, f'you want, I'll be glad, transfer your load. . .  	. .  I, uh, I don't want to change it, I'd rather wait.  
I figure, we can't be any safer than in here.	...you think pretty good on your feet.
...what is it?	Why'd you have to hit him?
I'm getting too close to you?	Yeah, you're gettin' too close to me.
Yeah, you're gettin' too close to me.	Uh huh. What? I took the thrill out of "slumming..."
...we're going to the rendezvous.	Let's get there.
Let's get there.	We got twelve hours.
We got twelve hours.	Yeah, no, let's go now.
Yeah, no, let's go now.	The truck's broken.
...why don't we just?	Because if you sold everybody else out, why wouldn't you sell me out?
Yes. Thank you. I know what you said.	What're you, filled with Remorse, something...?
What're you, filled with Remorse, something...?	...this is our exit.
...this is our exit.	Are you filled with remorse...?
Are you filled with remorse...?	...not yet.
...not yet.	Well, good, cause...
...alright.	.  ?  YOU knew that. . .  only one who didn't know that was. . .  
.  ?  YOU knew that. . .  only one who didn't know that was. . .  	You missed the exit for the meet.
What am I, just going to go off with you forever?	You want me to tell you why...?
You want me to tell you why...?	Take me to the Meet.
...I need a drink. Turn around.	...nothing simpler.
...we can get a few, we can bury the bars, if we bury the bars in the...	For godsake, walk away from it. Leave it...
...thank God.	...precious stuff, huh?
...come to dinner.	We're gonna have to see.
We're gonna have to see.	You always say that, and it means you won't.
You always say that, and it means you won't.	Well, it's possible, it's possible, you see, that my 'business'...
Well, it's possible, it's possible, you see, that my 'business'...	...uh huh...
...uh huh...	...that I might have to go 'travelling' for a while...
...that I might have to go 'travelling' for a while...	Why can't you do your business here?
Why can't you do your business here?	Wish I could, Baby. Fact it. Fact is: I got to get out of here, this morning.
Wish I could, Baby. Fact it. Fact is: I got to get out of here, this morning.	This morning?
This morning?	That's when my plane leaves.
Well, there you go. Times change. My day, all kids, had to walk all the way to school.	Yes. But the streets were safer.
Good day for the race.	What race is that?
...hey...	You're gonna be telling us the area codes, Belgium and Luxembourg...
The way you're looking at the deal the deal was we get away with the gold. Cute huh?	Yeah, no. It's charming. And then what?
Yeah, no. It's charming. And then what?	We, uh, we "slip away."
We, uh, we "slip away."	Zat the thing? 
Zat the thing? 	Well, you know, Joe figured, you weren't never going to the Meet.
...You know:	Yeah, no, where's the Gold, what's the Back-up Plan...?
Yeah, no, where's the Gold, what's the Back-up Plan...?	You can understand my reluctance to tell you.
Fran...?	No, she won't be calling in till she ditches the guy.
No, she won't be calling in till she ditches the guy.	How's she gonna ditch him?
Pinky Called.	Yeah.
Yeah.	What's the report?
What's the report?	Says he's fine.
Says he's fine.	He said so, huh?
He said so, huh?	That's what he said.
Yeah, yeah, what there was a change in Plans...? You couldn't get to me to tell me?	Let my wife go.
What is your real name?	It's Rumplestiltskin.
Let the girl go, I'll give up the gold.	.  a different deal.  How bout that, I hear, if you're flexible, it Keeps you Young.  
.  a different deal.  How bout that, I hear, if you're flexible, it Keeps you Young.  	I'll give up the Gold, Me and the girl leave on the boat.
I'll give up the Gold, Me and the girl leave on the boat.	Well, that's very sentimental. But what if the gold's on the boat.
Yeah, that's what we did for her, we let you live.	I gave you up. I had to.
Hold on, hold on, let's siddown...	. .  
. .  	One second. Hold on...
Too bad about Pinky.	Ain't that so.
Yeah?	Why'd they call him Robert "The" Bruce...
Why'd they call him Robert "The" Bruce...	...what?
Send your cut there...?	Wire it there, when you get where you're going.
I hear it's nice down there in the Sun.	Zat where I'm going?
Yeah, I knew you'd show.	Good, good plan, baby...
That's the right way to do it.	End of the day, though, end of the day, what's the important thing...?
End of the day, though, end of the day, what's the important thing...?	That's right.
C'mon, get in, we'll talk on the road. You heard about Pinky...	Yeah. I heard. I'm sorry about that.
Yeah. I heard. I'm sorry about that.	Yeah, well, it just went bad there, that little bit. Dinnit...?
...yes, it did... it got kind of convincing.	...and, so, you got hurt.
...and, so, you got hurt.	Well, you can't do it halfway, can you...?
Well, you can't do it halfway, can you...?	No, anything you do, you got to do full-out. Don't you?
No, anything you do, you got to do full-out. Don't you?	Indeed you do.
...what d'you mean, "that's part of it?"	I don't get you?
I don't get you?	I was talking about Pinky.
Was it...?	You shouldn't of sent me to him.
Well...	I'm sorry...
Why dun' he shoot me?	Cause it's over. It's all done. That's the deal.
Cause it's over. It's all done. That's the deal.	He ain't gonna shoot me?
He ain't gonna shoot me?	No.
I'm sorry, Baby.	Well, no. You told me, "you knew him before."
Hmm.	It was a pretty plan, though, wunnit...?
It was a pretty plan, though, wunnit...?	Cute as a Chinese baby...
You'll be alright.	You think so?
...the best laid plans of mice and men...	...what?
