Lila, what are you doing in there? I need to get ready for my date.	Nothing! I'll be out in a minute!
I don't know why you didn't tell me about this.	It's embarrassing, okay?
It's embarrassing, okay?	It's not so bad. So, it just keeps growing?
It's not so bad. So, it just keeps growing?	Yeah, Natalie. It's hair. It grows.
Yeah, Natalie. It's hair. It grows.	Well, don't jump down my throat. I'm just trying to help.
Well, don't jump down my throat. I'm just trying to help.	How is that helping, Natalie? How exactly?
How is that helping, Natalie? How exactly?	Look, if you're going to be like that... You should be appreciative that I'm interested.
I tried being a lesbian separatist.	A woman without a man / Is like a fish without a bicycle.
During the holiday season, they made us wear costumes.	Ho ho ho.
Ho ho ho.	That's not real.
That's not real.	Ow! You little fuck.
Progress!	Ouch. Yeah?
Ouch. Yeah?	Oh yes, honey. Getting to be smooth smooth smooth all over. Smooth as a baby's butt.
Oh yes, honey. Getting to be smooth smooth smooth all over. Smooth as a baby's butt.	I love it, Rose. I'm getting to be a real girl.
I love it, Rose. I'm getting to be a real girl.	You still in the market for a real boy?
You still in the market for a real boy?	Always. Ow.
Always. Ow.	Cause there's this guy. My brother knows him. Might be right up your alley.
Cause there's this guy. My brother knows him. Might be right up your alley.	Tell me. I could use someone up my alley.
Tell me. I could use someone up my alley.	I don't get that. Is that sexual?
I don't get that. Is that sexual?	Shut up and tell me.
Shut up and tell me.	Handsome, thirties, psychologist...
Handsome, thirties, psychologist...	Loves animals? Ouch. Must love animals, Rose.
Loves animals? Ouch. Must love animals, Rose.	Loves animals. Loves you.
Loves animals. Loves you.	What do you mean?
What do you mean?	Mr.  handsome, animal- loving psychologist said he would love to meet you.  
Mr.  handsome, animal- loving psychologist said he would love to meet you.  	Holy shit. Your brother didn't tell him about the nature of our relationship, did he?
Holy shit. Your brother didn't tell him about the nature of our relationship, did he?	My brother is discreet.
My brother is discreet.	Won't he be able to tell?
Meditations on a Banana Slug was a delightful read.	Thank you so much. I love slugs. All slugs, not just banana slugs.
Thank you so much. I love slugs. All slugs, not just banana slugs.	As do I.
As do I.	They don't care that people look at them and go, "Ewww.  A slug. " 
They don't care that people look at them and go, "Ewww.  A slug. " 	They don't seem to be especially ego driven, this is true.
They don't seem to be especially ego driven, this is true.	You've got to respect that.
You've got to respect that.	I have to say that I'm not there yet.
I have to say that I'm not there yet.	Where?
Where?	Slugdom. Sluggishness. Whatever you'd call it. I'm not there yet. I still have many human characteristics.
Slugdom. Sluggishness. Whatever you'd call it. I'm not there yet. I still have many human characteristics.	That's not necessarily a bad thing.
That's not necessarily a bad thing.	Yes. I suppose not. But still. One would like to move along. To move beyond.
Yes. I suppose not. But still. One would like to move along. To move beyond.	Believe me I've tried.  I'm not even so sure anymore that we should want to.  
Believe me I've tried.  I'm not even so sure anymore that we should want to.  	 Realizing how much a product I am of my upbringing I've been seeing someone.  A therapist.  
 Realizing how much a product I am of my upbringing I've been seeing someone.  A therapist.  	You are a therapist, right?
You are a therapist, right?	I'm a behaviorist.  I work with animals.  Mice at the moment.  
I'm a behaviorist.  I work with animals.  Mice at the moment.  	I hope you don't perform any of those dreadful torture experiments, Nathan.
I hope you don't perform any of those dreadful torture experiments, Nathan.	Heavens no. My work now is... Right now I'm teaching mice... well, table manners, to be candid.
Heavens no. My work now is... Right now I'm teaching mice... well, table manners, to be candid.	How's it going?
How's it going?	Right now I've gotten two of my subjects to use napkins.  Tiny napkins of course.  
Right now I've gotten two of my subjects to use napkins.  Tiny napkins of course.  	Paper or cloth?
Paper or cloth?	It's important work.  It's part of a larger sociological experiment.  I'm federally funded.  
It's important work.  It's part of a larger sociological experiment.  I'm federally funded.  	What's the larger experiment?
What's the larger experiment?	It's my thesis that if table manners can be taught to mice, they can be taught to humans.
It's my thesis that if table manners can be taught to mice, they can be taught to humans.	Going out on a limb, aren't you, Nathan?
I'm not sure.	Courtesy, decorum, manners, are all sadly lacking from our daily intercourse. Rudeness, vulgarity, meanness are the norm.
Courtesy, decorum, manners, are all sadly lacking from our daily intercourse. Rudeness, vulgarity, meanness are the norm.	We are animals after all.
So?	I really like him, Rose. He's so... ...passionate about his work.
I really like him, Rose. He's so... ...passionate about his work.	My brother says he likes you, too.
My brother says he likes you, too.	Really?
It looks wonderful.	Work is going splendidly and my personal life is . . .  
Work is going splendidly and my personal life is . . .  	Um-mmm. Oh Nathan, this salad is delish...
Um-mmm. Oh Nathan, this salad is delish...	My God! The fork! The fork!
My God! The fork! The fork!	I'm sorry?
I'm sorry?	One goes from the outside in as the dinner progresses.  
One goes from the outside in as the dinner progresses.  	Oh, I'm sorry. I'm sorry, Nathan. I never really learned those things.
Oh, I'm sorry. I'm sorry, Nathan. I never really learned those things.	No biggie.
No biggie.	Boy, this is good!
Boy, this is good!	I'm sorry that I became so upset.
I'm sorry that I became so upset.	No, I'm sorry. I'm really backward in certain areas.
No, I'm sorry. I'm really backward in certain areas.	It's only that I really enjoy your company and...
It's only that I really enjoy your company and...	You do?
You do?	Yes, and...
Yes, and...	You really enjoy my company?
You really enjoy my company?	You're so pretty and it only mars your. . .  I'm sorry.  I'm being critical.  
You're so pretty and it only mars your. . .  I'm sorry.  I'm being critical.  	It's just that I have some peculiarities, and...
It's just that I have some peculiarities, and...	I like you, too, Nathan.
I like you, too, Nathan.	You do?
You do?	Yeah But I have some peculiarities also.
Yeah But I have some peculiarities also.	I don't care. I don't care! (then, concerned) Like what, for example?
My brother says things are going really well between you and Nathan.	I cannot believe how in love I am with this man.
I cannot believe how in love I am with this man.	Yeah?
Yeah?	Rose, we connect on every level.  I've finally found someone I can feel completely safe with.  
Rose, we connect on every level.  I've finally found someone I can feel completely safe with.  	I had that once with a guy.  But I threw it away for a cheap thrill.  
I had that once with a guy.  But I threw it away for a cheap thrill.  	One night stand?
One night stand?	No. I married a midget.
No. I married a midget.	Marrying a midget was a cheap thrill?
Marrying a midget was a cheap thrill?	Had he been an actual midget, there would've been nothing cheap about it, my dear.  
Had he been an actual midget, there would've been nothing cheap about it, my dear.  	I didn't know you were into that sort of thing.
I didn't know you were into that sort of thing.	And they're exactly the right height for a little covert oral fun on the dance floor.  
And they're exactly the right height for a little covert oral fun on the dance floor.  	I have a friend you might like to meet.
I have a friend you might like to meet.	Oh?
Oh?	Three foot one.
Three foot one.	Be still my crotch.
Be still my crotch.	Rose, Nathan's no midget, but he's asked me to move in with him.
Rose, Nathan's no midget, but he's asked me to move in with him.	Yeah. My brother told me.
Yeah. My brother told me.	And I think I'm going to.
What are you doing in there?	I'll be out in a minute.
I'll be out in a minute.	I'm sorry about my parents.
I'm sorry about my parents.	You didn't seem sorry when you were laughing at all your mother's stupid, tasteless, cruel animal jokes.
You didn't seem sorry when you were laughing at all your mother's stupid, tasteless, cruel animal jokes.	I was simply attempting to keep the evening light. You know that I feel similarly to you about nature.
I was simply attempting to keep the evening light. You know that I feel similarly to you about nature.	Do you?
Do you?	Of course. I simply love the... naturalness of it all.
Of course. I simply love the... naturalness of it all.	Do you? Oh do you, darling?
Do you? Oh do you, darling?	Why certainly!
Why certainly!	Oh, darling. I'm so relieved. Let's celebrate with a long hike in the woods tomorrow!
Oh, darling. I'm so relieved. Let's celebrate with a long hike in the woods tomorrow!	That's a great idea.
That's a great idea.	It'll be wonderful! I'll show you my old stomping grounds!
It'll be wonderful! I'll show you my old stomping grounds!	Terrific. Can't wait!
Terrific. Can't wait!	Shaving cream?
Darling, did you bring the insect repellent lotion?	Yes, darling.
Yes, darling.	Oh, and the sun block?
Oh, and the sun block?	Of course.
Of course.	What SPF, sweetie?
What SPF, sweetie?	Fifteen.
Fifteen.	?  Think of all the time one would save 
?  Think of all the time one would save 	Yes, darling.
Yes, darling.	I think I'll get Johannsen in chemistry on that. Oh! Did you bring the first aid kit?
I think I'll get Johannsen in chemistry on that. Oh! Did you bring the first aid kit?	Yes.
Yes.	Flares?
Flares?	Absolutely.
Absolutely.	We could call it "Quit Bugging Me, Sunny." Get it? Sunny. S-u-n-n-y.
We could call it "Quit Bugging Me, Sunny." Get it? Sunny. S-u-n-n-y.	That's very funny.
Did you see that?	What?
What?	I don't know. Something.
I don't know. Something.	A deer?
A deer?	No. Too... upright. Might've been a person.
No. Too... upright. Might've been a person.	It might behoove us to turn back at this point.
It might behoove us to turn back at this point.	Come on.
Come on.	They live in the woods because they're anti-social, Lila.  We have to respect that.  
They live in the woods because they're anti-social, Lila.  We have to respect that.  	This is it.  Bingo !  Lyme Disease !  You've hit the nail on the head here.  
Who are you?	You don't understand my language, do you?
You don't understand my language, do you?	I take it back, you do understand my language.
I take it back, you do understand my language.	Oh God.
Oh God.	Oh my God! Is he dead? Please put something on.
Oh my God! Is he dead? Please put something on.	You'll catch cold. It's cold. What do you suppose he is, a survivalist?
You'll catch cold. It's cold. What do you suppose he is, a survivalist?	I think he's feral.
I think he's feral.	Feral? Don't touch him! He might be diseased! He might... My God, rabies!
Feral? Don't touch him! He might be diseased! He might... My God, rabies!	He looks perfectly fine.
He looks perfectly fine.	Please.  Before he wakes up and, I don't know, eats us, or whatever feral things do.  
Please.  Before he wakes up and, I don't know, eats us, or whatever feral things do.  	. .  
. .  	Actually, I just had an amusing thought.
Actually, I just had an amusing thought.	What?
What?	Feral, huh? Totally uncontaminated?
Feral, huh? Totally uncontaminated?	Look at him. He doesn't understand English. He moves like an animal.
Look at him. He doesn't understand English. He moves like an animal.	It's perfect!
It's perfect!	Nathan, what the hell are you talking about?
Nathan, what the hell are you talking about?	Forget mice! Actually forget guinea pigs, cats, monkeys, and chimps also. I'm on to stage five: The human subject.
Forget mice! Actually forget guinea pigs, cats, monkeys, and chimps also. I'm on to stage five: The human subject.	Oh no. You can't take him from his home, Nathan.
Oh no. You can't take him from his home, Nathan.	 He's my ticket to the top of the Behaviorist food chain He's going to make me famous.  
 He's my ticket to the top of the Behaviorist food chain He's going to make me famous.  	I won't allow you. It's wrong. He's happy here.
You'd be taking away his freedom, Nathan.	Freedom's just another word for nothing left to lose, Lila, to quote Janet Jackson.
?  Think of this poor soul's education as the greatest gift we could bestow upon. .  	All right.
Doctor...	Good morning.
Good morning.	Only three shocks. A chimp takes fifteen. This is going to be tres simple, no, Gabrielle?
Only three shocks. A chimp takes fifteen. This is going to be tres simple, no, Gabrielle?	Oui, doctor, oui.
Oui, doctor, oui.	Good morning... (to Gabrielle) We need a name for him, don't we?
Good morning... (to Gabrielle) We need a name for him, don't we?	Oui.
Oui.	You decide. Today is your day.
You decide. Today is your day.	!  So cute !  I loved my doggie very much, monsieur 
!  So cute !  I loved my doggie very much, monsieur 	Puff it is then. Puff Bronfman. Is that okay?
Puff it is then. Puff Bronfman. Is that okay?	Oui. Perfect!
Oui. Perfect!	Bronfman and this is my assistant Gabrielle.  We're your mommy and daddy while you are here.  
Dr. Bronfman! Dr. Bronfman!	Oh, Hi, Gabrielle.
Oh, Hi, Gabrielle.	(blushes) Now I'm embarrassed that I say this.  
(blushes) Now I'm embarrassed that I say this.  	No. Don't be. I really enjoy hearing that. You're a terrific assistant.
No. Don't be. I really enjoy hearing that. You're a terrific assistant.	Merci. I... Do you... would you like to go get a cup of coffee, perhaps?
Merci. I... Do you... would you like to go get a cup of coffee, perhaps?	Well, I don't know. I'm actually on my way to...
Well, I don't know. I'm actually on my way to...	I know you are a very important man and. . .  
I know you are a very important man and. . .  	No. Don't be silly. It's just...
Thank you so much for accompanying me.	Not at all.
Not at all.	. .  but I'm talking too much again, no? 
. .  but I'm talking too much again, no? 	Of course not.
Of course not.	You're so sweet. Oh, why are there not more men out there like you?
You're so sweet. Oh, why are there not more men out there like you?	There there.
There there.	You know just the right thing to say.
You know just the right thing to say.	Listen, you're the best assistant I've ever had... Gabrielle.
What are you doing in there?	Nothing. Be right out.
Nothing. Be right out.	Hello? Oh, hi... Gabrielle!
Hello? Oh, hi... Gabrielle!	Who is it?
Who is it?	Uh-huh. Right, Gabrielle. Right.
Uh-huh. Right, Gabrielle. Right.	Who is it?
Who is it?	Absolutely, Gabrielle. (covering phone, testily) Someone from work! (into phone) Sorry about that, Gabrielle. Uh-huh. Exactly.
Absolutely, Gabrielle. (covering phone, testily) Someone from work! (into phone) Sorry about that, Gabrielle. Uh-huh. Exactly.	Who from work?
Who from work?	Excuse me one second, would you, Gabrielle?
Excuse me one second, would you, Gabrielle?	Who is it, Nathan?
Who is it, Nathan?	Look, Lila, when I'm on a work...
It's hormonal, Nathan. I can't help it. I'm sorry.	Your entire body?
Your entire body?	I'm getting electrolysis. It's working, but it takes time. So meanwhile I have to...
I'm getting electrolysis. It's working, but it takes time. So meanwhile I have to...	You have to shave? Like an ape?
You have to shave? Like an ape?	Apes don't shave, you son of a bitch!
Apes don't shave, you son of a bitch!	Don't quibble. You know what I mean.
Don't quibble. You know what I mean.	I'm sorry. Please don't be mad at me for this.
I'm sorry. Please don't be mad at me for this.	Mad? I'm I'm... disgusted!
Mad? I'm I'm... disgusted!	I'm the same person I was before you knew, damn it! Oh God!
I'm the same person I was before you knew, damn it! Oh God!	I have to think! I have to think!
I mean, she doesn't mind that I have a mortifyingly small. . .  	Oh, Doctor. I did not know. I'm sorry to disturb you. I just came for some papers I left.
Oh, Doctor. I did not know. I'm sorry to disturb you. I just came for some papers I left.	Gabrielle. No, I'm sorry if I startled you. I came to think. God, Did I hang up on you?
Gabrielle. No, I'm sorry if I startled you. I came to think. God, Did I hang up on you?	Oui. Perhaps I called at a bad time. I am sorry.
Oui. Perhaps I called at a bad time. I am sorry.	No. I just got distracted. I'm so sorry.
No. I just got distracted. I'm so sorry.	Is everything fine?
Is everything fine?	Oui. Now you've got me talking French.
Oui. Now you've got me talking French.	?  I rushed right out of the house I must look a mess.  I'm so embarrassed.  
?  I rushed right out of the house I must look a mess.  I'm so embarrassed.  	I'm in my p.j.'s, too. Funny, huh?
I'm in my p.j.'s, too. Funny, huh?	Coincidence, yes? And how is our son?
Coincidence, yes? And how is our son?	Our...? Oh! He seems fine. I guess we woke him. The lights and all.
Our...? Oh! He seems fine. I guess we woke him. The lights and all.	Maybe I sing him a lullaby my mama sang to me when I was a little girl.  
Maybe I sing him a lullaby my mama sang to me when I was a little girl.  	When you were a little French girl?
When you were a little French girl?	Oui.
Oui.	That would be good.
That would be good.	There.
There.	Shall we close up, then?
Shall we close up, then?	Maybe we should just sit for a while. It's very peaceful.
Maybe we should just sit for a while. It's very peaceful.	I'm glad I ran into you, both in our silly pajamas.  It is two happy coincidences, no? 
I'm glad I ran into you, both in our silly pajamas.  It is two happy coincidences, no? 	Yes. Happy happy.
Yes. Happy happy.	Yet you look so sad. A great man like you should not be sad.
Yet you look so sad. A great man like you should not be sad.	I'm fine. Life is funny, that's all.
I'm fine. Life is funny, that's all.	I am sleepy.
I am sleepy.	I shouldn't say this, but you're pretty, Gabrielle. It's unprofessional, I know.
I shouldn't say this, but you're pretty, Gabrielle. It's unprofessional, I know.	Really? I always think myself so ugly. No, not ugly, but plain. A wallflower.
Really? I always think myself so ugly. No, not ugly, but plain. A wallflower.	Really? No. Not at all. You're a very pretty girl. You should know that. You should be confident.
Really? No. Not at all. You're a very pretty girl. You should know that. You should be confident.	Thank you so much. Merci. It's very wonderful to hear a man say such a nice compliment.
Thank you so much. Merci. It's very wonderful to hear a man say such a nice compliment.	It's true. I wouldn't lie.
It's true. I wouldn't lie.	You are sweet.
You are sweet.	Doctor.
Doctor.	So soft. So smooth. I'm sorry. It's just...
Excellent, Puff. Now, the lady you're with excuses herself to go powder her nose.	Perfect. Perfect, Puff!
Perfect. Perfect, Puff!	Dr. Bronfman's line. Yes. One moment please. (puts it on hold) Lila.
So, how's it going today?	Good. Making progress.
Are you seeing somebody else, Nathan? I just have to know.	Of course not.
Of course not.	It would just be helpful to know.
It would just be helpful to know.	No.
No.	. .  I don't know.  It feels different.  
. .  I don't know.  It feels different.  	I'm just preoccupied.
I'm just preoccupied.	Do you like my new look?
Do you like my new look?	Yeah. It's nice. It's really good.
Yeah. It's nice. It's really good.	 I want to be what you want, Nathan All I want is to be what you want.  
 I want to be what you want, Nathan All I want is to be what you want.  	You're what I want.  You know that.  You're exactly what I want.  
You're what I want.  You know that.  You're exactly what I want.  	Really?
Really?	Sure. Of course.
Sure. Of course.	Because I'm really trying, you know. Rosie says maybe only another two years of the elctrolysis.
Because I'm really trying, you know. Rosie says maybe only another two years of the elctrolysis.	That's great.
That's great.	I've signed up for a ballet class. And look at my nails! A real girl!
I've signed up for a ballet class. And look at my nails! A real girl!	That's great. It's a great color for you.
So anyway, that's the nightmare I've been having lately.	Do you suppose it has anything to do with Lila's unusually hairy body?
Do you suppose it has anything to do with Lila's unusually hairy body?	No, why?
That's very good.  That's what you get the big bucks, right ?  Ha ha.  	I just think it might be important to explore your feelings for Lila.
I just think it might be important to explore your feelings for Lila.	!  Lila's not going to leave me because of my eyesight What about my penis? 
My little French.	Stop. Get away.
Stop. Get away.	What is it?
What is it?	 Did you ever see that movie, Sophie's Choice ?  It is like that Only it is this.  
 Did you ever see that movie, Sophie's Choice ?  It is like that Only it is this.  	Gabby, you know I'm trying to sort things out.
I love you so much, Gabrielle.	But?... But? There is a "but," Nathan.
But?... But? There is a "but," Nathan.	But I don't know how to leave Lila.
Oh! I didn't see you there, sneaky boy! (runs over and kisses him) You're like a boy sneaking in...	...the back door of a movie theater. Yes, indeed.
...the back door of a movie theater. Yes, indeed.	You remember that from my book? I'm touched! What's wrong?
You remember that from my book? I'm touched! What's wrong?	Nothing. Hard day. Gonna have a drink.
Nothing. Hard day. Gonna have a drink.	I know what you drink.  (pours and blends and shakes, etc. ) Voila !  
I know what you drink.  (pours and blends and shakes, etc. ) Voila !  	Thanks.
Thanks.	How's work?
How's work?	Cruddy, okay? Are you satisfied?
Cruddy, okay? Are you satisfied?	No. I don't want your work to be cruddy.
No. I don't want your work to be cruddy.	My assistant quit today. Okay? He was highly valuable to the project.
My assistant quit today. Okay? He was highly valuable to the project.	Oh, baby. I'm sorry. Can't you hire somebody else?
Oh, baby. I'm sorry. Can't you hire somebody else?	I guess.
I guess.	!  I know I haven't been all that supportive of this project, but I've come around 
!  I know I haven't been all that supportive of this project, but I've come around 	Have you?
Have you?	!  What a wonderful wonderful compassionate man you are !  
!  What a wonderful wonderful compassionate man you are !  	Really?
Really?	 You won't have to pay me, and I was thinking of giving up that crazy nature writing anyway 
 You won't have to pay me, and I was thinking of giving up that crazy nature writing anyway 	How come?
How come?	!  I love being a woman because. .  
!  I love being a woman because. .  	Such as what womanly things?
I don't think this aversion therapy is really necessary, doctor. I understand the problem.	Humor me, Puff. It's essential that I am able to trust you to function independently in the world.
Humor me, Puff. It's essential that I am able to trust you to function independently in the world.	I bow to your expertise in these matters.
I bow to your expertise in these matters.	Lila?
Lila?	Good. You're doing fine.
Good. You're doing fine.	Excellent.
Excellent.	You're doing very nicely, Puff. I'm pleased.
You're doing very nicely, Puff. I'm pleased.	Great...
Great...	Eh.
Eh.	Excellent work, Puff. Extra desert tonight.
Excellent work, Puff. Extra desert tonight.	Yahoo!
I'm going to go down and check on Puff. See how he's holding up.	Should I come with?
Should I come with?	Nah. You just relax. How's the book?
Nah. You just relax. How's the book?	Ummm. It's good.
 (beat) Yeah, no duh !  I had a wild hair up my ass over that for a month 	Yeah? What?
Yeah? What?	Hi. It's Nathan.
Hi. It's Nathan.	Call you back. (hangs up, assumes French accent) You bastard! What do you want?
Call you back. (hangs up, assumes French accent) You bastard! What do you want?	I just want to talk.
Please. Just one minute of your time.	!  Now I hate you !  No, I don't hate you ;  I don't even think about you !  
Like what?	Well, I think it would be easier if I could talk to you in person.
Well, I think...	. .  is what I need !  
. .  is what I need !  	What?
What?	!  Go away from here !  
!  Go away from here !  	Well, look, I'm sorry to have bothered you.
Well?	God, you're beautiful.
God, you're beautiful.	Please. I look a mess.
Please. I look a mess.	No. You look so beautiful.
No. You look so beautiful.	Anyway. Come already to the point.
Anyway. Come already to the point.	I'm... I'm going to leave Lila. I can't stop thinking about you.
I'm... I'm going to leave Lila. I can't stop thinking about you.	I've moved on.
I've moved on.	No!
No!	I've been seeing Johannsen in chemistry.
I've been seeing Johannsen in chemistry.	!  Did you know that? !  
!  Did you know that? !  	That's not how he tells it.
That's not how he tells it.	Of course not, that Swedish thief! He's a thief of hearts! I love you, Gabrielle.
Of course not, that Swedish thief! He's a thief of hearts! I love you, Gabrielle.	Hunh.
Hunh.	She's a really nice girl and I don't want to hurt her more than is necessary.  
She's a really nice girl and I don't want to hurt her more than is necessary.  	You hurt me, you know, when you made Nathan's Choice. Does that not even matter to you, you pig?
Hey.	You were gone a long time.
You were gone a long time.	He's going to make us famous, Lila.  
He's going to make us famous, Lila.  	So he's doing okay?
So he's doing okay?	Seemed fine. Quiet evening enjoying his new digs.
Seemed fine. Quiet evening enjoying his new digs.	!  Oh, and what did you do tonight, honey? 
!  Oh, and what did you do tonight, honey? 	Shit.
Shit.	And what did you do tonight, honey?
And what did you do tonight, honey?	I've fallen in love with somebody else, Lila.
I've fallen in love with somebody else, Lila.	And what did you do tonight, honey?
And what did you do tonight, honey?	I fucked her! Okay? I fucked her. I'm sorry. But that's what the hell I did.
I fucked her! Okay? I fucked her. I'm sorry. But that's what the hell I did.	Do you know what I gave up to be with you?
Do you know what I gave up to be with you?	Yes.
Yes.	I gave up my soul, my beliefs. I gave up my body hair!
I gave up my soul, my beliefs. I gave up my body hair!	Yeah, well, I'm sorry. The human heart is a strange thing.
Yeah, well, I'm sorry. The human heart is a strange thing.	How the hell would you know anything about the human heart?
How the hell would you know anything about the human heart?	Lila...
No maid service! For God's sake, can't you read the fucking "do not disturb" sign on the fucking doorknob?	Lila, it's Rosie.
Lila, it's Rosie.	Go the fuck away, Rosie.
Go the fuck away, Rosie.	Please, honey, let me in.
Please, honey, let me in.	Rose, please go away.
Rose, please go away.	Lila, I want to help you.
Lila, I want to help you.	How'd you know where I was?
How'd you know where I was?	Nathan told my brother.
Nathan told my brother.	Your brother should have his license revoked.
Your brother should have his license revoked.	Yeah, although I'm not going to turn him in. I like hearing the dirt.
Yeah, although I'm not going to turn him in. I like hearing the dirt.	Why didn't your brother tell you that Nathan was having an affair?
Why didn't your brother tell you that Nathan was having an affair?	I don't know, honey. I don't know. Maybe he just didn't want to get involved.
I don't know, honey. I don't know. Maybe he just didn't want to get involved.	Oh, Rosie.
Oh, Rosie.	 Free electrolysis, if you want it !  We'll get that face of yours cleared up in no time 
Out.	Bad.
Bad.	Get up.
Get up.	Take off your clothes.
Take off your clothes.	I'm going to make you free again if I have to kill you doing it.  
I'm going to make you free again if I have to kill you doing it.  	But I like being human now.
But I like being human now.	You what?
You what?	I want to be the way I was before.
Nice night.	There is no other reason.  
There is no other reason.  	I agree?
I want our boy back.	Oui.
Oui.	That bitch. I worked so hard. We worked so hard, you and I. He would've made us famous.
That bitch. I worked so hard. We worked so hard, you and I. He would've made us famous.	We still have you and I.
Where do we look for little lost Puff?	I have some thoughts. I think that hairy bitch is somewhere trying to turn him back into an ape.
I have some thoughts. I think that hairy bitch is somewhere trying to turn him back into an ape.	That is horrible. Apes are dirty. No?
That is horrible. Apes are dirty. No?	You better believe they're dirty! And smelly! And messy! And they don't know their forks from their assholes!
You better believe they're dirty! And smelly! And messy! And they don't know their forks from their assholes!	I'm going alone. This could be dangerous.
I'm going alone. This could be dangerous.	Okay, my sweet. Good night.
Okay, my sweet. Good night.	A little resistance would be nice, damn it.
A little resistance would be nice, damn it.	Please let me go with you.
Please let me go with you.	No.
He's dead.	We bury the body. We disappear into the woods. Nobody knows.
Forget him, Lila. We'll disappear. We'll never talk about it again. We'll never talk again period. I love you.	I'm taking responsibility for the murder.  I want you to go back to your old life.  
I'm taking responsibility for the murder.  I want you to go back to your old life.  	I won't let you do that. I shot the bastard. And I'm glad.
I won't let you do that. I shot the bastard. And I'm glad.	See, I could never be free again anyway, so I might as well be in jail.  
See, I could never be free again anyway, so I might as well be in jail.  	I'll be the most free, truest animal in the whole forest.  For both of us.  
I'll be the most free, truest animal in the whole forest.  For both of us.  	That's what I'm counting on.
That's what I'm counting on.	But first I'll live among them, just long enough to testify before congress about the waywardness of humankind.
I will live out my days naked and free.  	Thank you, sir. Your story has touched us all deeply. We will pass some legislation addressing this problem.
Wait!	Yes?
Yes?	Then there you were, such a beautiful, beautiful grown man.  
Then there you were, such a beautiful, beautiful grown man.  	Mother?
Mother?	Yes... Derek.
Yes... Derek.	.  (checks watch) And I have to go back into the woods now. . .  forever.  
.  (checks watch) And I have to go back into the woods now. . .  forever.  	It's good to see you again though.  
It's good to see you again though.  	Yes.
Yes.	I'm in the book, if you ever want to drop me a line or something.
Hello, my little boy.	Hey, ma. Did you bring any clothes? I'm freezing my ass off.
Hey, ma. Did you bring any clothes? I'm freezing my ass off.	Oui. Nathan's silk suit, just like you asked.
Oui. Nathan's silk suit, just like you asked.	Great. God, I've wanted you forever.
Great. God, I've wanted you forever.	Say my name.
Say my name.	Gabrielle.
Gabrielle.	You remind me so much of Nathan.
You remind me so much of Nathan.	Like father, like son.
Like father, like son.	You remind me so much of Nathan plus so much of my little mongrel doggie.
You remind me so much of Nathan plus so much of my little mongrel doggie.	Woof.
Woof.	Arf.
Arf.	Is that a terrible thing to say, my sweet? 
Is that a terrible thing to say, my sweet? 	But you have something more.  You have a bit of the animal in you.  
But you have something more.  You have a bit of the animal in you.  	Let's go eat, I'm starved.
Let's go eat, I'm starved.	French?
