Come on in, Charlie. Have a seat.	I'm glad you called me in. I'm still unclear on a couple things
I'm glad you called me in. I'm still unclear on a couple things	Oh, really? Like what?
Oh, really? Like what?	Well, if I'm the G.M., who's gonna be the Manager?
Well, if I'm the G.M., who's gonna be the Manager?	I was thinking of Lou Brown.
I think he'll fit right in with our team concept.	What exactly is our team concept?
What exactly is our team concept?	I want to put together a team that will help us relocate to Miami.  
I want to put together a team that will help us relocate to Miami.  	What do you mean? Some of these guys are furniture movers?
What do you mean? Some of these guys are furniture movers?	Another couple of years of this and I'm gonna have to start feeding Cha-Cha dog food.  
If we play bad enough, we should be able to come in under that.	What are you saying? You want us to lose?
What are you saying? You want us to lose?	No, we've been losing. What I want us to do is finish dead last.
No, we've been losing. What I want us to do is finish dead last.	Mister Phelps would never have approved of this.
Yeh, well, I'm not sure I can make it by then.	Don't worry, we're gettin' you out on a sort of work furlough deal. Any questions?
Look, Lou, you been in baseball thirty years. Don't you wanna advance some?	I used to coach the unwed mothers' softball team. I have advanced some.
I used to coach the unwed mothers' softball team. I have advanced some.	Well, what are you really worried about? The money?
Well, what are you really worried about? The money?	Owners are always on your back, tryin' to "help you out. " 
Owners are always on your back, tryin' to "help you out. " 	I don't think that's gonna be a problem.
I don't think that's gonna be a problem.	I don't wanta be a babysitter for a buncha millionaires who think they know it all already.  
I don't wanta be a babysitter for a buncha millionaires who think they know it all already.  	We don't have any millionaires.
We don't have any millionaires.	Well then, bonus babies or whatever you got...
Well then, bonus babies or whatever you got...	Don't have any bonus babies either.
Don't have any bonus babies either.	Don't you have any proven major league talent?
Don't you have any proven major league talent?	Not that I know of.
Not that I know of.	Well, then... I'll be up in a couple days.
Well, then... I'll be up in a couple days.	What?
What?	Sounds like my kinda team. Have my contracts ready.
Let's go, Taylor. You're up.	Luis, I'm not gonna be playin' anymore. I got a tryout in the States.
Luis, I'm not gonna be playin' anymore. I got a tryout in the States.	Fine. Leave your uniform.
Fine. Leave your uniform.	But I changed at the motel.
Who's that?	I think it's Cerrano. Defected from Cuba. Wanted religious freedom.
I think it's Cerrano. Defected from Cuba. Wanted religious freedom.	What's his religion?
Thought you didn't have any high- priced talent.	I forgot about Dorn, 'cause he's only high-priced. Got him as a free agent three years ago.
I forgot about Dorn, 'cause he's only high-priced. Got him as a free agent three years ago.	Still hits the ball pretty well, doesn't he?
Still hits the ball pretty well, doesn't he?	Yeh, he just can't field it.
How the knees holdin' up, Jake?	Great. Never been better.
Great. Never been better.	Mobility's good? No problem gettin' off the throw to second?
Mobility's good? No problem gettin' off the throw to second?	No problem.
C'mon, Hayes, this isn't the All Star Game. Get up to the damn plate.	Well, you may run like Mays, but you hit like shit.
C'mon, Dorn, get in front of the damn ball. Don't give me this ole' bullshit.	I took one of these in the eye last year. Nearly lost my sight.
I took one of these in the eye last year. Nearly lost my sight.	I'm deeply moved. Every time you play it off your hip, you give me forty sit-ups.
I'm deeply moved. Every time you play it off your hip, you give me forty sit-ups.	What! That's Little League shit.
Good, I like that kinda spirit in a player. The only problem is, I didn't cut you.	What do you mean?
Forget about Dorn. You got other things to do.	Like what?
Hello, Cuyahoga Sheet Metal.	You got anybody workin' there named Lynn Wells?
You got anybody workin' there named Lynn Wells?	Never heard of her.
God, I was horse shit tonight.	Only thing you got to be sorry about was hittin' Coleman.
Only thing you got to be sorry about was hittin' Coleman.	What?
What?	He hit the damn homer.  Coleman was just picking his nose in the on-deck circle.  
He hit the damn homer.  Coleman was just picking his nose in the on-deck circle.  	 Besides, Haywood didn't hit it that good That ball wouldn't have been out of a lotta parks.  
 Besides, Haywood didn't hit it that good That ball wouldn't have been out of a lotta parks.  	Oh yeh, name one.
Oh yeh, name one.	Yellowstone.
Jake, you shouldn't have come here.	I was wonderin' why you'd give an old friend a bum phone number.
I was wonderin' why you'd give an old friend a bum phone number.	Let's talk in my office, okay?
Let's talk in my office, okay?	I don't wanna talk in your office.
I don't wanna talk in your office.	I told you I don't think it's a good idea for us to see each other.
I told you I don't think it's a good idea for us to see each other.	Why not?
Why not?	We don't have anything in common. Sometimes I wonder if we ever did.
We don't have anything in common. Sometimes I wonder if we ever did.	?  We were both athletes, world class, hot for each other What more can you have in common? 
?  We were both athletes, world class, hot for each other What more can you have in common? 	I stopped bein' an athlete three years ago. Books are my life now.
I stopped bein' an athlete three years ago. Books are my life now.	In two years I've put together one of the best special collections departments in the country.  
In two years I've put together one of the best special collections departments in the country.  	So what is it? You're still sore I never read Moby Dick?
So what is it? You're still sore I never read Moby Dick?	You never read anything I asked you to.
You never read anything I asked you to.	Not like what's-his-name at the restaurant?
Not like what's-his-name at the restaurant?	His name is Tom, and keep your voice down.
His name is Tom, and keep your voice down.	What do ya see in this guy?
What do ya see in this guy?	He's stable. He's intelligent... and I've never found him in bed with a stewardess.
He's stable. He's intelligent... and I've never found him in bed with a stewardess.	That's 'cause no stewardess would have him. Wouldn't you rather be with somebody who's in demand?
That's 'cause no stewardess would have him. Wouldn't you rather be with somebody who's in demand?	Just like always, you don't take anything seriously. Everything's a joke to you.
Just like always, you don't take anything seriously. Everything's a joke to you.	C'mon, Lynn, for Christ sake, I'm just tryin' to loosen things up a little. I'm gettin' frostbite here.
C'mon, Lynn, for Christ sake, I'm just tryin' to loosen things up a little. I'm gettin' frostbite here.	Tom and I are getting married in the fall.
Tom and I are getting married in the fall.	What? That's crazy, Lynn. I got plans for us.
What? That's crazy, Lynn. I got plans for us.	What plans?
?  I haven't seen you in two years You never even wrote me a letter.  	C'mon, you didn't think about me at all since I been gone? 
C'mon, you didn't think about me at all since I been gone? 	Not so loud, Jake.
Not so loud, Jake.	?  You have nights like that with Mr Briefcase? 
?  You have nights like that with Mr Briefcase? 	What about the night you had in Detroit with Miss Dairy Queen?
What about the night you had in Detroit with Miss Dairy Queen?	I had to defend your honor.  
I had to defend your honor.  	What a bunch of bullshit! (exasperated) I have a much better body than she does.
What a bunch of bullshit! (exasperated) I have a much better body than she does.	 I mean Miss Dairy Queen has quantity, I give her that, but the, ah, quality just isn't there 
 I mean Miss Dairy Queen has quantity, I give her that, but the, ah, quality just isn't there 	How many think Lynn oughta give me another shot?
How many think Lynn oughta give me another shot?	The ayes have it.
The ayes have it.	You haven't changed at all, have you?
You haven't changed at all, have you?	C'mon, Lynn, I don't wanna do time for things that happened years ago.  
C'mon, Lynn, I don't wanna do time for things that happened years ago.  	I'm sorry, Jake. You'll always be the little boy who wouldn't grow up.
Who you got lined up tonight?	Where are we? Kansas City, right? Gotta be Arlene
Where are we? Kansas City, right? Gotta be Arlene	You call her?
What'd I tell ya.	Hi, Rodger. This is Vicki and Rene.
Hi, Rodger. This is Vicki and Rene.	Hi, doll. This is Steve Harris.
Hi, doll. This is Steve Harris.	Where's your buddy Gant?
Where's your buddy Gant?	They cut him to make room for bristle boy over there.
They cut him to make room for bristle boy over there.	Is that Vaughn, the guy they call Wild Thing?
Is that Vaughn, the guy they call Wild Thing?	Yeh.
Yeh.	He's kinda cute. They say he could be a big star.
He's kinda cute. They say he could be a big star.	What are you talkin' about? He couldn't find the plate if it was magnetized. He won't last the year.
What are you talkin' about? He couldn't find the plate if it was magnetized. He won't last the year.	He struck out five in a row before the wild pitches. Maybe I'll check him out.
He struck out five in a row before the wild pitches. Maybe I'll check him out.	Wait a minute, you're with me.
Wait a minute, you're with me.	I don't remember you makin' any date.
"Moby Dick?" What is that?	It's one of the masterpieces of American literature, that's all.
It's one of the masterpieces of American literature, that's all.	Lynn put you on to this?
Lynn put you on to this?	Long time ago.
Long time ago.	Well, we're goin' to a club tonight. You wanna come along?
Well, we're goin' to a club tonight. You wanna come along?	No, I got some more reading to do.
No, I got some more reading to do.	?  Maybe she'll let you slide on a couple of these 
?  Maybe she'll let you slide on a couple of these 	I might if I knew where she lives.
I might if I knew where she lives.	Easy. Tail her home from the library.
Easy. Tail her home from the library.	You mean sit in a car and wait for her to come out? That's kinda juvenile, don't you think?
Well, I gotta be goin'. Nice to have met you all.	Let me walk you out.
Let me walk you out.	Thanks for the beer.
Thanks for the beer.	Don't mention it.
Don't mention it.	I'll let you know if I land a good job. I know you're concerned about it.
I'll let you know if I land a good job. I know you're concerned about it.	Yeh, well, I just wanted Lynn to know what she would've had ahead of her.
Yeh, well, I just wanted Lynn to know what she would've had ahead of her.	Stay away from her.
Take Sandy Koufax there. . .  	What about Koufax?
What about Koufax?	Never mind Koufax.
Never mind Koufax.	Read these letters, starting at the top.
Read these letters, starting at the top.	Can't read it, can you?
Can't read it, can you?	You gonna send me to the minors?
You still got that great kick. Just like the first time I ever saw you.	You follow me here too?
You follow me here too?	Yeh, what did you want to see me about?
Yeh, what did you want to see me about?	What do you mean?
What do you mean?	You wouldn't have been at the game if you didn't want to see me about something.
You wouldn't have been at the game if you didn't want to see me about something.	I just wanted to see you play.
I just wanted to see you play.	How was I?
How was I?	You looked good, but you oughta open your stance a little. They're pitching you inside.
You looked good, but you oughta open your stance a little. They're pitching you inside.	I'll try that. You wanna have some dinner?
I'll try that. You wanna have some dinner?	Sorry, I already ate.
Sorry, I already ate.	Right. I forgot your life is different now.
Right. I forgot your life is different now.	Thanks for the race.
Whose place are we at this time?	Mine. You follow me again?
Mine. You follow me again?	Yeh. When I saw you at the game, I figured you wanted to see me about something.
Yeh. When I saw you at the game, I figured you wanted to see me about something.	I just wanted to see you play.
I just wanted to see you play.	How was I?
How was I?	You looked good, but you oughta open your stance a little. They're pitchin' you inside.
You looked good, but you oughta open your stance a little. They're pitchin' you inside.	I'll try that.
I'll try that.	I think I oughta tell you that I'm moving in with Tom.
I think I oughta tell you that I'm moving in with Tom.	Goin' uptown, huh?
Goin' uptown, huh?	You know, like an adult maybe.  With a house and a garden and normal hours.  
You know, like an adult maybe.  With a house and a garden and normal hours.  	You think I can't lead a regular life?
You think I can't lead a regular life?	It was a guy to serve you with a paternity suit.  
It was a guy to serve you with a paternity suit.  	That was a hoax. The girl was just trying to get some publicity.
That was a hoax. The girl was just trying to get some publicity.	Yes, but you had obviously been with her. And it happened in front of all our friends.
Yes, but you had obviously been with her. And it happened in front of all our friends.	Thinkin' about you was the only thing that kept me goin' in Mexico.  
Thinkin' about you was the only thing that kept me goin' in Mexico.  	I've come back to you too many times, Jake. I can't afford to believe you anymore.
I've come back to you too many times, Jake. I can't afford to believe you anymore.	I guess this is our last hurrah then.
I guess this is our last hurrah then.	I guess so. Did you really read "Moby Dick?"
I guess so. Did you really read "Moby Dick?"	Cover to cover.
Cover to cover.	When's the wedding?
When's the wedding?	October third.
October third.	Your mom and dad like this guy?
Your mom and dad like this guy?	You're still their favorite.
Where?	At any library.
At any library.	I mean the wedding.
I mean the wedding.	All Saints on Euclid.
All Saints on Euclid.	Nice church.
Nice church.	Yeh. Who saved Ishmael at the end?
Yeh. Who saved Ishmael at the end?	Nobody. It was Queequeg's coffin. Am I invited?
Nobody. It was Queequeg's coffin. Am I invited?	Where?
Where?	To the wedding.
To the wedding.	If you want. Maybe you really did read it.
If you want. Maybe you really did read it.	This doesn't change anything, you know. We were always good at this.
This doesn't change anything, you know. We were always good at this.	Lynn?
Lynn?	What?
What?	The zipper on your skirt is stuck.
Maybe you just have to accept the fact that they're not as bad as you'd hoped.	At the first sign of a slump they'll give up on this team.  
At the first sign of a slump they'll give up on this team.  	What's left to do? You've taken away everything you can.
Can I borrow one of those, man? They don't have any magazines on this bus.	Sure, go ahead. I think my reading days are over.
Sure, go ahead. I think my reading days are over.	Macbeth. This a good one?
I'll trade you Song of Hiawatha for The Deerslayer.	Naw, I'm not into Song of Hiawatha.
Naw, I'm not into Song of Hiawatha.	All right then, how about Crime and Punishment?
All right then, how about Crime and Punishment?	Yeh, that sounds pretty good. That's a detective story, right?
You still got that black Corvette? The one that the sound system took up the whole trunk?	No, I had to sell it.
No, I had to sell it.	I thought they gave them to ya.
I thought they gave them to ya.	Not after your knees go bad.
Not after your knees go bad.	That's all right, you'll be gettin' a new one now.
That's all right, you'll be gettin' a new one now.	Darla, I don't think I can do this.
Darla, I don't think I can do this.	What do you mean? We did this between innings once.
What do you mean? We did this between innings once.	I guess I'm just not that guy anymore.
He's got more experience and a little better record against the Yankees.	Yeh, sure. Whatever's best for the team.
Yeh, sure. Whatever's best for the team.	Don't read anything into it, Rick. You're one of the guys that got us here.
Where you goin'?	I've gotta get home.
I've gotta get home.	I didn't even get your name.
I didn't even get your name.	Suzanne. Suzanne Dorn
Suzanne. Suzanne Dorn	Suzanne Dorn?
You look beautiful.	Thank you. I didn't think you'd come.
Thank you. I didn't think you'd come.	I can't stay. We gotta get to the park.
No, I came to see you.	I just wanna say I'm sorry for all the things I've put you through over the years.  
I just wanna say I'm sorry for all the things I've put you through over the years.  	Even for last night?
Even for last night?	Can't be sorry for that. Nothing happened.
Can't be sorry for that. Nothing happened.	Then you weren't defending my honor again?
Come in.	Hello, Lou, what can I do for ya?
Hello, Lou, what can I do for ya?	I wanted to hand in my resignation before you had a chance to fire me.
I wanted to hand in my resignation before you had a chance to fire me.	What do you mean?
What do you mean?	After the season, I want no part of it.  
After the season, I want no part of it.  	I was just afraid he might take too long.  
I was just afraid he might take too long.  	Why would you want him to tell somebody?
Why would you want him to tell somebody?	I think it worked.  
I think it worked.  	You tryin' to make me believe you wanted us to win all along?
You tryin' to make me believe you wanted us to win all along?	Bullshit. What about the plane, the bus, the bad hotels...
Bullshit. What about the plane, the bus, the bad hotels...	There was never any offer from Miami.  I made it all up.  
There was never any offer from Miami.  I made it all up.  	?  Now that we're winnin' it's easy for you to jump on the bandwagon 
?  Now that we're winnin' it's easy for you to jump on the bandwagon 	But I didn't, did I? 
But I didn't, did I? 	And if you tell them any of this, I will fire you.  
You listenin' to me Rick? 	O.K., kid, you're my man. Let's go get him.
