...yes I'm still on hold...	And what was this?
And what was this?	I'm looking at your advertisement for the airline promotion and giveaway?
I'm looking at your advertisement for the airline promotion and giveaway?	This is "Fly With Us?"
This is "Fly With Us?"	. .  
....I'm not exactly sure what that means...	If they break or something. What is it, plastic?
Ok. Maybe I'll see you later. Thank you for your help.	Thank you.
Thank you.	Maybe I'll see you later, when I pick up my car?
Hey, good morning, Barry.	Hey...Lance....can I.....
Hey...Lance....can I.....	You ok?
You ok?	Yes I'm fine.
Yes I'm fine.	Why you wearin' a suit?
Why you wearin' a suit?	I thought maybe it would be nice to get dressed for work, can I show you something? 
I thought maybe it would be nice to get dressed for work, can I show you something? 	Yeah.....you got here early huh?
Yeah.....you got here early huh?	....yes.....
....yes.....	What is this?
What is this?	I don't know. I think it's a piano....a small piano.
I don't know. I think it's a piano....a small piano.	That's not a piano.....I have a piano at home.....where'd you get it?
That's not a piano.....I have a piano at home.....where'd you get it?	Well.....it was dropped on the street.....
Well.....it was dropped on the street.....	Why is it here? Barry....Barry?
This is Barry.	Hey it's me, what are you doing?
Hey it's me, what are you doing?	Hello, Karen. I'm just working.
Hello, Karen. I'm just working.	Yeah but what are you doing?
Yeah but what are you doing?	I'm just working....I have some customers here.....
I'm just working....I have some customers here.....	So you can't talk to me?
So you can't talk to me?	I have a few people here, I can't really chat right now.
This is Barry.	What are you doing?
What are you doing?	Hi, Kathleen, I'm just working.
Hi, Kathleen, I'm just working.	Are you going to the party tonight?
Are you going to the party tonight?	Yes I am.
Yes I am.	What are you doing?
What are you doing?	Nothing.
Nothing.	Right now, you're doing nothing?
Right now, you're doing nothing?	I'm just talking on the phone to you and standing.
I'm just talking on the phone to you and standing.	What time are you gonna be there?
What time are you gonna be there?	Seven o'clock.
Seven o'clock.	You can't be late.
You can't be late.	I won't.
I won't.	I'm serious.
I'm serious.	I know.
I know.	Seriously.
Seriously.	Ok.
Ok.	You can't be late though.
You can't be late though.	I know.
I know.	You can't just not show up like you do, you have to go.
You can't just not show up like you do, you have to go.	I know.
I know.	Seriously.
Seriously.	I know.
I know.	You can't just stay in your house.
You can't just stay in your house.	I know.
I know.	Yeah but I'm serious.
Yeah but I'm serious.	Ok.
Ok.	I'll see you there.
I'll see you there.	I'll see you there.
I'll see you there.	Don't puss out.
I'm trying to be your friend.	I know.
What's up?	Well I'm sorry. Before...
Well I'm sorry. Before...	Mhm.
Mhm.	And I'm sorry that I did that.
And I'm sorry that I did that.	It's alright.
It's alright.	I wanted to ask you because you're a doctor, right?
I wanted to ask you because you're a doctor, right?	Yeah.
Yeah.	I don't like the way I am sometimes. Can you help me?
I don't like the way I am sometimes. Can you help me?	Barry, I'm a dentist, what kind of help do you think I can give you?
Barry, I'm a dentist, what kind of help do you think I can give you?	I know that. Maybe you know other doctors?
I know that. Maybe you know other doctors?	Like a psychiatrist?
but what exactly is wrong? 	. . . . Sometimes I cry a lot. . . . . for no reason.  
Hi, this is Janice The Operator, who's this?	Hello, how are you?
Hello, how are you?	Hi, is this your first time calling?
Hi, is this your first time calling?	Yes it is.
Yes it is.	Can I have your credit card number, followed by the expiration date?
......and this is confidential?	What do you mean?
What do you mean?	It's....confidential, the call, my information is private.
And your name?	Barry Egan.
Barry Egan.	And your Social Security number.
And your Social Security number.	What's that for?
It's ok, take your time.	337-09-9876. But I don't want anyone to know my name.
337-09-9876. But I don't want anyone to know my name.	No one will know your name.
No one will know your name.	Can you say that my name is Jack?
Can you say that my name is Jack?	You want her to call you Jack?
You want her to call you Jack?	I just don't want anyone to know it's me.
I just don't want anyone to know it's me.	That's fine. Can I have a telephone number, area code first on where we can call you back?
Hello, this is Back.	Hi, is this Jack?
Hi, is this Jack?	Yes.
Yes.	This is Georgia.
This is Georgia.	Hi. This is Jack.
Hi. This is Jack.	So what are you doing tonight, Jack?
So what are you doing tonight, Jack?	Nothing.
Nothing.	Nothing, huh, do you know what I'm doing?
Nothing, huh, do you know what I'm doing?	No.
No.	I'm just laying on my bed.
I'm just laying on my bed.	Where are you?
Where are you?	I'm in my bedroom.
I'm in my bedroom.	No, I mean, what city, what state are you in?
No, I mean, what city, what state are you in?	Are you watching a porno movie?
Are you watching a porno movie?	No.
No.	Do you like porno movies?
Do you like porno movies?	Sure.
Sure.	Yeah....? So...Jack...are you stroking that big fat fucking cock of yours?
Yeah....? So...Jack...are you stroking that big fat fucking cock of yours?	....no....
....no....	Yeah? So what are you doing, then?
Yeah? So what are you doing, then?	...just talking to you....
...just talking to you....	Are your pants off?
Are your pants off?	No.
No.	I'm wearing a t-shirt and panties.
I'm wearing a t-shirt and panties.	Really?
Really?	Yeah. And looking at myself in the mirror. Do you wanna know what I look like?
Yeah. And looking at myself in the mirror. Do you wanna know what I look like?	It doesn't matter.
It doesn't matter.	What do you mean it doesn't matter?
Really?	What do you mean, "really?" Yeah. Really. What about you?
What do you mean, "really?" Yeah. Really. What about you?	It doesn't matter.
It doesn't matter.	Yeah....you're married aren't you, Jack?
Yeah....you're married aren't you, Jack?	No.
No.	You have a girlfriend?
You have a girlfriend?	...yes...
...yes...	Where is she?
I'm horny, Jack, what about you?	...yeah.....
...yeah.....	Does Jack like to Jack Off?
Does Jack like to Jack Off?	Sometimes when I'm lonely.
Sometimes when I'm lonely.	...yeah....well you have me now.
...yeah....well you have me now.	You sound very cute, very nice.
You sound very cute, very nice.	Thank you. What do you do, Barry?
Thank you. What do you do, Barry?	I have my own business....I work. I work hard at doing my business.
I have my own business....I work. I work hard at doing my business.	Yeah....do you do well, do you make alotta money?
Yeah....do you do well, do you make alotta money?	. I'd like to diversify. . . but I'm doing great, I think, as a start.  
. I'd like to diversify. . . but I'm doing great, I think, as a start.  	So.....are you stroking it, yet, honey?
So.....are you stroking it, yet, honey?	No.
No.	Well why don't you take your pants off and stroke it for me?
Well why don't you take your pants off and stroke it for me?	Ok.
Hello?	Hey. What are you doing? How are you?
Hey. What are you doing? How are you?	I'm fine. Who is this?
Hi....what....what's up....?	It's ok that I'm calling, right, I mean? It's ok.
It's ok that I'm calling, right, I mean? It's ok.	Yeah. No. It's ok. What's goin' on?
I'm going to work.	Uhhh...I am sooo tired...I stayed up too late last night, what about you, when did you go to sleep?
Uhhh...I am sooo tired...I stayed up too late last night, what about you, when did you go to sleep?	Not very late.
Not very late.	You're going to work now?
You're going to work now?	Yes.
Yes.	Can I ask you a question?
Yes.	. .  I was wondering if you could help me out with a little bit of money.  
. .  I was wondering if you could help me out with a little bit of money.  	Me?
Me?	Yeah.
Yeah.	I can't really. Yeah, no. I mean. I can't afford it.
I can't really. Yeah, no. I mean. I can't afford it.	You don't even know how much it is.
You don't even know how much it is.	I know but I....how much is it?
I know but I....how much is it?	Like seven-fifty. Seven hundred fifty?
Like seven-fifty. Seven hundred fifty?	Yes, no, yes. I can't. I can't afford that. I'm sorry. Sorry.
Yes, no, yes. I can't. I can't afford that. I'm sorry. Sorry.	Really? Please?
Really? Please?	You have trouble, financial trouble?
You have trouble, financial trouble?	Yeah. It's so hard these days and I really need it.
Yeah. It's so hard these days and I really need it.	Yes I can't....I don't make enough money to be able to do that.
Yes I can't....I don't make enough money to be able to do that.	I thought you had your own business. You said you were gonna diversify and all that stuff....
I thought you had your own business. You said you were gonna diversify and all that stuff....	So you think you can?
So you think you can?	No. I'm sorry.
No. I'm sorry.	Should I call back and talk to your girlfriend?
Good morning, Barry....	Hi, Lance.
You're goin' on a trip?	No.........but airline miles are just like a currency these days.
No.........but airline miles are just like a currency these days.	You should go on a trip.
You should go on a trip.	No thanks.
No thanks.	So what should I do with the pudding?
I know I did. But I don't.	You lied to me?
You lied to me?	I didn't lie.
I didn't lie.	Why did you tell me you did, then?
Why did you tell me you did, then?	This is....illegal....I'll call the police.
I'll go pay for my car.	Are you sure?
This is not cool.	It was cool last night.
It was cool last night.	I have to go.
I have to go.	Are you telling me no?
Are you telling me no?	No I'm sorry, now I have to get off the phone....
I feel really on the spot now.	Are you gonna do it?
Are you gonna do it?	I don't do that. I don't - things like that.
I'm not gonna rag you. Why would I do this just to rag you?	I don't know.
I don't know.	Can I ask you a serious question: 
Can I ask you a serious question: 	What?
What?	Barry, did you ask Walter to get you a shrink ?  What's wrong with you ?  Are you ok? 
Barry, did you ask Walter to get you a shrink ?  What's wrong with you ?  Are you ok? 	I didn't ask him that. He's lying.
That must be nice. That must be really, really, really great.	It's terrible, no.
It's terrible, no.	What do you do with all this pudding?
What do you do with all this pudding?	That's not mine it's one of the guys that works here. That pudding's not mine.
That's not mine it's one of the guys that works here. That pudding's not mine.	Oh My God.
Oh My God.	It's ok. That's ok. How long have you worked with Elizabeth?
It's ok. That's ok. How long have you worked with Elizabeth?	Six months, maybe five, five or six months...do you wanna check that?
Who is it?	It's Barry.
That's very nice. Thank you. Thank you for saying that. You're friends with my sister?	Yeah.
Yeah.	How long have you known her?
How long have you known her?	About six months.
About six months.	You like her?
You like her?	Yeah. Yeah we get along well. You didn't get along with her very well?
Yeah. Yeah we get along well. You didn't get along with her very well?	Did you really come to meet me on purpose or are you lying about that?
Did you really come to meet me on purpose or are you lying about that?	No, no. I did.
No, no. I did.	Do you remember all that pudding? 
Do you remember all that pudding? 	Yeah.
Yeah.	. . . .  
. . . .  	Yeah?
That's insane. That is really, really crazy. That's just crazy if you spend three thousand dollars on pudding.	....yeah....
....yeah....	So that was your pudding?
Sir, the bathroom was just torn apart.	Yeah.
Yeah.	Did you do it?
Did you do it?	No.
No.	You didn't just smash up the bathroom?
You didn't just smash up the bathroom?	No.
No.	Well who did?
Well who did?	I don't know.
I don't know.	You're hand is bleeding.
You're hand is bleeding.	I cut myself.
I cut myself.	How?
How?	On my knife.
On my knife.	Sir, a young man saw you coming out of the bathroom.
Why? ...what?	Your hand is bleeding.
Your hand is bleeding.	I know.
I know.	I'm gonna have to ask you to leave.
I didn't do it.	Alright, well you're gonna have to leave. You're gonna have to go.
Alright, well you're gonna have to leave. You're gonna have to go.	Yeah, but I didn't do anything.
Yeah, but I didn't do anything.	I'm gonna call the police then, sir.
I'm gonna call the police then, sir.	Please don't do this to me.
Please don't do this to me.	The police are on their way.
The police are on their way.	Sorry.
Sorry.	Can I pay you here? Can I pay you for our drinks and salad?
Can I pay you here? Can I pay you for our drinks and salad?	That's fine.
We should go I think, I don't like it here.	Ok.
Ok.	Is everything ok?
Is everything ok?	Yes.
Yes.	What happened?
What happened?	Nothing.
Nothing.	What did he want?
What did he want?	Nothing.
Nothing.	I have a better idea of where we can go.
I have a better idea of where we can go.	Ok.
Ok.	There's a better place for us to eat.
There's a better place for us to eat.	Did something happen; are you alright?
So....how is your harmonium doing?	Your portable reed organ....the piano.
Your portable reed organ....the piano.	Well, it's fine. Thank you.
Well, it's fine. Thank you.	Did you pick it up from the street?
Did you pick it up from the street?	What?
What?	Did you take it from the street in front of your work?
Did you take it from the street in front of your work?	...yes I did...?
...yes I did...?	Are you learning how to play it?
Are you learning how to play it?	Yes? I'm trying.
I don't know.	So maybe in that time. . . .  
That was good.	Yeah.
Yeah.	I'll see you later.
I'll see you later.	Ok.
Ok.	I don't freak out very often.
I don't freak out very often.	What do you mean?
What do you mean?	I don't, no matter what my sisters say, ok?
I don't, no matter what my sisters say, ok?	...I don't know what you mean....
...I don't know what you mean....	I don't freak out.
I don't freak out.	Ok.
Ok.	Have a good trip.
Hey.	Hi.
Hi.	I need to talk to you for a second.
I need to talk to you for a second.	What?
What?	You gotta give me some money.
It's three hundred and twenty dollars, just take it.	What do you have in the house?
What do you have in the house?	Nothing....I mean, really...change, nothing....that's the cash I have....
Nothing....I mean, really...change, nothing....that's the cash I have....	You have an ATM?
You have an ATM?	Yes.
Yes.	Is this where you live?
Is this where you live?	Yes.
Yes.	You have another house somewhere or something?
Ok. Well. I'm gonna go out of town. I'm going to go out of town just for two days...	Where you goin?
Yeah but you can't tell my sisters that.	Ok.
Ok.	So can you come and help me out? 
. .  	What is this, man?
What is this, man?	I'm sorry.
I'm sorry.	Are you serious with this?
Are you serious with this?	Yes. Sorry.
Yes. Sorry.	Well....what do you want, then?
Well....what do you want, then?	Each pudding cup has to be scanned individually so that...it's for a giveaway...a product giveaway by this company...
Each pudding cup has to be scanned individually so that...it's for a giveaway...a product giveaway by this company...	This is a bunch of bullshit.
This is a bunch of bullshit.	I'm sorry, I know. I know that it's....
I'm sorry, I know. I know that it's....	I'm sorry, I'm really sorry.
You know you can get places in the world with pudding. That's funny.	Yeah.
Ok.  But here's the thing I gotta tell you: 	....now: this pudding?
....she didn't, I didn't ask her out?	You're so scared.
You're so scared.	Do you know where she's staying in Hawaii?
Do you know where she's staying in Hawaii?	Oh My God, yeah, I know exactly where she is, why?
Oh My God, yeah, I know exactly where she is, why?	......she forgot her purse at my work and I wanted to get it back to her.
......she forgot her purse at my work and I wanted to get it back to her.	No she didn't; that's a lie.
Well let's do something do you want to do something, can you meet me?	You don't have a boyfriend or anything do you?
You don't have a boyfriend or anything do you?	No. What do you mean?
No. What do you mean?	I just wanted to know. When was the last time you had a boyfriend?
I just wanted to know. When was the last time you had a boyfriend?	About six months ago. Why?
About six months ago. Why?	I just wanted to make sure.
I just wanted to make sure.	When was the last time you had a girlfriend?
When was the last time you had a girlfriend?	Where you married?
Where you married?	yeah.
yeah.	Ok. So you were married for how long?
Ok. So you were married for how long?	Do you want to meet me and talk about this stuff?
You got me out of my hotel room. You came and got me out of my room.	Yeah......yeah.....
Yeah......yeah.....	It's so nice.
Do you wanna have sex?	Yeah.
Yeah.	Press together. It feels good.
Press together. It feels good.	Oh my god, you are so adorable. I just....god dammit.
Oh my god, you are so adorable. I just....god dammit.	What's that? What is that that you're doing?
Fuck.  	This is funny.
This is funny.	Yeah.
That guy had more money to give up.	Long way to drive just for seven hundred something bucks. Dean doesn't have to know.
You know you're not supposed to do that. Because I told you. Seriously. Please. Not that day. Ok.	Barry?
How many times have you been on an airplane?	I think maybe over a hundred.
I think maybe over a hundred.	That's right you travel so much.
That's right you travel so much.	Yeah.
Yeah.	How much do you travel? You travel all the time?
How much do you travel? You travel all the time?	I forgot about that.
I forgot about that.	Can I come home with you when we get there?
Can I come home with you when we get there?	Yeah.
Yeah.	It's ok to ask that.
Are you ok?	I'm fine are you ok?
I'm fine are you ok?	Yes I'm sorry.
Yes I'm sorry.	What is this?
...people are just crazy in this world, I think....	...and he came up on the driver side...
...and he came up on the driver side...	The first man came on the driver side....
The first man came on the driver side....	...right...the blonde one?
...no....I don't....I don't remember you. Who's this?	Please connect me now.  
What did you say?	Nothing.
Why don't you shut the fuck up?	What?
What city?	Somewhere in Utah.
Somewhere in Utah.	What's the listing?
You left me at the hospital.	I'm sorry.
I'm sorry.	You can't do that.
