Give me more angle-control on the bounce.	Benissimo, Professore.
We flopped the first time out.	At the sub-atomic level, particles obey their own logic. They connect in unimaginable ways.
At the sub-atomic level, particles obey their own logic. They connect in unimaginable ways.	And you think this is relevant to our relationship?
And you think this is relevant to our relationship?	Could be.
Could be.	What universe are you in, Paul?
What universe are you in, Paul?	A quantum one.
They come into being as one or the other at the moment we observe them.	Nothing is real until it's perceived.
Nothing is real until it's perceived.	The Buddhists have been saying that for a millennium.
The Buddhists have been saying that for a millennium.	How?
How?	Baby, reality is what you choose to make it.
But only if you live your life that way. If you experience every moment as discovery.	Mia! You're restoring heaven with dabs of paint. You're bringing new order to the universe.
Mia! You're restoring heaven with dabs of paint. You're bringing new order to the universe.	I always said we were in the same business...
God. I dunno. The eternal nothingness. Mia.	The universe is snapping my head back. I'm losing my focus.
The universe is snapping my head back. I'm losing my focus.	Welcome, Paul. Welcome.
Welcome, Paul. Welcome.	"Things fall apart; the center will not hold. Mere anarchy is loosed upon the world."
"Things fall apart; the center will not hold. Mere anarchy is loosed upon the world."	An electron spoke to me yesterday. I swear.
An electron spoke to me yesterday. I swear.	What did it want?
What did it want?	"What do you want?" I didn't answer.  I was in the middle of an experiment.  
"What do you want?" I didn't answer.  I was in the middle of an experiment.  	Like now?
Like now?	Yes.
Yes.	Did you know electrons have lovers?
Did you know electrons have lovers?	No. I didn't. I'm listening.
No. I didn't. I'm listening.	Inside every semi-conductor... you have two particles, with opposite charges, separated by an impassable barrier...
Paul... Pauly...	I... I thought you were dead.
To a biblical spoof of a crazed father firing a gun at his only son.  	You taking any medication?
You taking any medication?	One: how did a celebrated life of the mind bring me to this particular switching station? 
One: how did a celebrated life of the mind bring me to this particular switching station? 	Dad...
Dad...	Two: what if I didn't miss?
Two: what if I didn't miss?	You did.
Mia. I can create reality. I can choose to love you with all my heart.	.  ?  I came to take back my picture.  The one I keep leaving with you.  
.  ?  I came to take back my picture.  The one I keep leaving with you.  	Why?
Why?	So I can move on. You too.
