We're just gonna sit here, and wait for Joe.  Who are we waiting for? 	Joe.
Joe.	Bet your sweet ass we are.
Bet your sweet ass we are.	Don't leave me!
Don't leave me!	I ain't going anywhere. I'm right here. I'm not gonna leave ya.
I ain't going anywhere. I'm right here. I'm not gonna leave ya.	Larry, I'm so scared, would you please hold me.
Larry, I'm so scared, would you please hold me.	When Joe gets here, he'll make ya a hundred percent again.  
When Joe gets here, he'll make ya a hundred percent again.  	I don't give a fuck about jail, I just don't wanna die.  
I don't give a fuck about jail, I just don't wanna die.  	You're not gonna fucking die, all right?
You're not gonna fucking die, all right?	I wasn't born yesterday. I'm hurt, and I'm hurt bad.
I wasn't born yesterday. I'm hurt, and I'm hurt bad.	It's not good...
It's not good...	The situation is, I'm shot in the belly.  And without medical attention, I'm gonna die.  
The situation is, I'm shot in the belly.  And without medical attention, I'm gonna die.  	I can' take you to a hospital.
And I did, and I didn't, because of fuckin money !  	What's done is done, I need you cool. Are you cool?
What's done is done, I need you cool. Are you cool?	I'm cool.
I'm cool.	Splash some water on your face. Take a breather.
Splash some water on your face. Take a breather.	I'm gonna get me my smokes.
I'm gonna get me my smokes.	Want a smoke?
What's wrong with it?	They didn't show till after Mr.  Blonde started shooting everyone.  
They didn't show till after Mr.  Blonde started shooting everyone.  	As soon as I heard the alarm, I saw the cops.
Tagged a couple of cops. Did you kill anybody?	A few cops.
A few cops.	No real people?
No real people?	Uh-uh, just cops.
Uh-uh, just cops.	Could you believe Mr. Blonde?
Could you believe Mr. Blonde?	Why the fuck would Joe hire somebody like that? 
I mean, Jesus Christ, how old do you think that black girl was ?  Twenty, maybe twenty-one? 	Did ya see what happened to anybody else?
Did ya see what happened to anybody else?	Brown floored it.  After that, I don't know what went down.  
Brown floored it.  After that, I don't know what went down.  	Blue are concerned, I ain't got the foggiest.  Once I got out, I never looked back.  
Blue are concerned, I ain't got the foggiest.  Once I got out, I never looked back.  	What do you think?
What do you think?	What do I think? I think the cops caught them, or killed 'em.
What do I think? I think the cops caught them, or killed 'em.	Not even a chance they punched through? You found a hole.
Nope.	How can you be so sure?
How can you be so sure?	I got the diamonds.
I got the diamonds.	Where?
Where?	I got 'em, all right?
I got 'em, all right?	Where? Are they out in the car?
Where? Are they out in the car?	And I'm thinkin we should have our fuckin heads examined for waiting around here.  
And I'm thinkin we should have our fuckin heads examined for waiting around here.  	That was the plan, we meet here.
That was the plan, we meet here.	As we speak, the cops could be in their cars, drivin here this minute.  
As we speak, the cops could be in their cars, drivin here this minute.  	I swear to god I'm fuckin jinxed.
I swear to god I'm fuckin jinxed.	What?
What?	Two jobs back, it was a four man job, we discovered one of the team was an undercover cop.
Two jobs back, it was a four man job, we discovered one of the team was an undercover cop.	No shit?
No shit?	Thank god, we discovered in time. We hadda forget the whole fuckin thing. Just walked away from it.
Thank god, we discovered in time. We hadda forget the whole fuckin thing. Just walked away from it.	Maybe he set it up to set it up.  
Maybe he set it up to set it up.  	I can tell ya straight up, Joe definitely didn't have anything to do with this bullshit.  
I can tell ya straight up, Joe definitely didn't have anything to do with this bullshit.  	For all I know, you're the rat.  
For all I know, you're the rat.  	For all I know, you're the rat.
For all I know, you're the rat.	Now you're using your head. For all we know, he's the rat.
Is he dead?	So, is he dead or what?
So, is he dead or what?	He ain't dead.
He ain't dead.	So what is it?
So what is it?	I think he's just passed out.
I think he's just passed out.	He scared the fuckin shit outta me. I thought he was dead fer sure.
He scared the fuckin shit outta me. I thought he was dead fer sure.	He will be dead fer sure, if we don't get him to a hospital.
He will be dead fer sure, if we don't get him to a hospital.	We can't take him to a hospital.
We can't take him to a hospital.	And I'm not gonna just sit around and watch him die.  
And I'm not gonna just sit around and watch him die.  	Well, first things first, staying here's goofy. We gotta book up.
He begged me to do it.  I told him to hold off till Joe got here.  	 Now, I don't know a goddamn body who can help him, so if you know somebody, call 'em 
 Now, I don't know a goddamn body who can help him, so if you know somebody, call 'em 	I don't know anybody.
Well, he knows a little about me.	You didn't tell him your name, did ya?
You didn't tell him your name, did ya?	I told him my first name, and where I'm from.
I told him my first name, and where I'm from.	Why!
Why!	I told him where I was from a few days ago. It was just a casual conversation.
I told him where I was from a few days ago. It was just a casual conversation.	And what was tellin him your name when you weren't supposed to?
And what was tellin him your name when you weren't supposed to?	He asked.
Don't fuckin patronize me.	One question: Do they have a sheet on you, where you told him you're from?
One question: Do they have a sheet on you, where you told him you're from?	Of course.
Of course.	That's it right, you didn't tell him anything else that could narrow down the selection? 
That's it right, you didn't tell him anything else that could narrow down the selection? 	If I have to tell you again to back off, me an you are gonna go round and round.
If I have to tell you again to back off, me an you are gonna go round and round.	We ain't taking him to a hospital.
We ain't taking him to a hospital.	If we don't, he'll die.
If we don't, he'll die.	And I'm very sad about that. But some fellas are lucky, and some ain't.
Your boss even said there wasn't a set up.	First off, I don't have a boss. Are you clear about that?
First off, I don't have a boss. Are you clear about that?	I asked you a question. Are you clear about that?
I asked you a question. Are you clear about that?	Yes.
Woo all picked you up?	Nice Guy. When we got to the bar...
Nice Guy. When we got to the bar...	...What bar?
...What bar?	White.  It's a phony name.  My name's Mr.  Orange.  
White.  It's a phony name.  My name's Mr.  Orange.  	You ever seen this motherfucker before?
You ever seen this motherfucker before?	Who, Mr. White?
Who, Mr. White?	Yeah.
Yeah.	He's gotta be from outta town.  But Joe knows him real well.  
He's gotta be from outta town.  But Joe knows him real well.  	How can you tell?
How can you tell?	The way they talk to each other. You can tell they're buddies.
The way they talk to each other. You can tell they're buddies.	Did the two of you talk?
Did the two of you talk?	Me and Mr. White?
Me and Mr. White?	Yeah.
Yeah.	A little.
A little.	What about?
What about?	The Brewers.
The Brewers.	The Milwaukee Brewers?
The Milwaukee Brewers?	Yeah. They had just won the night before, and he made a killing off 'em.
What kinds questions did Cabot ask?	Where I was from, who I knew, how I knew Nice Guy, had I done time, shit like that.
Didja use the commode story?	Fuckin-A. I tell it real good, too.
Fuckin-A. I tell it real good, too.	What's this?
What's this?	It's a scene. Memorize it.
It's a scene. Memorize it.	What?
But what is this?	It's a amusing anecdote about a drug deal.
It's a amusing anecdote about a drug deal.	What?
What?	Something funny that happened to you while you were doing a job.
Something funny that happened to you while you were doing a job.	I gotta memorize all this shit?
...six Los Angeles County Sheriffs and a German Shepherd.	They were waiting for you?
So as soon as Joe Cabot shows up, we'll see it.  	What's your visibility of the interior?
What's your visibility of the interior?	We can't see shit on the inside. And we can't risk gettin any closer for fear they'll spot us.
?  No one lied to you You always knew we'd hang back until Joe Cabot showed up.  	Oh this is great. You ain't giving me no fuckin protection whatsoever. But you are giving me an attitude.
Oh this is great. You ain't giving me no fuckin protection whatsoever. But you are giving me an attitude.	We have to make do with the cards we're dealt.  
We have to make do with the cards we're dealt.  	I didn't say I wasn't gonna do it. I'm just remarking on how shitty the situation is!
I didn't say I wasn't gonna do it. I'm just remarking on how shitty the situation is!	We're willing to offer them good deals to testify against Cabot.  
We're willing to offer them good deals to testify against Cabot.  	Isn't this risk unorthodox?
Isn't this risk unorthodox?	What?
What?	Letting them go ahead with the robbery?
Letting them go ahead with the robbery?	We could replace the employees with cops, but we'd run the risk of tipping 'em off.  
We could replace the employees with cops, but we'd run the risk of tipping 'em off.  	That's out. They know the faces of who works what shift.
Let's go over it. Where are you?	I stand outside and guard the door. I don't let anybody come in or go out.
I stand outside and guard the door. I don't let anybody come in or go out.	Mr. Brown?
Myself and Mr. Pink?	What if the manager won't give up the diamonds? 
