Thor, Son of Odin.	Surtur. Son of a bitch...you're still alive! I thought my father killed you, like, half a million years ago.
Surtur. Son of a bitch...you're still alive! I thought my father killed you, like, half a million years ago.	I cannot die. Not until I fulfill my destiny and lay waste to your home.
A mountain!	The Eternal Flame that Odin keeps locked away on Asgard?
The Eternal Flame that Odin keeps locked away on Asgard?	Odin is not on Asgard. And your absence has left the throne defenseless.
Odin is not on Asgard. And your absence has left the throne defenseless.	Okay, so where is it? This crown?
Okay, so where is it? This crown?	This is my Crown, the source of my power.
This is my Crown, the source of my power.	Oh, that's a crown? I thought it was a big eyebrow.
Anyway, it sounds like all I have to do to stop Ragnarok is rip that thing off your head.	I am Asgard's doom, and so are you.  All will suffer, all will burn.  
You cannot stop Ragnarok. Why fight it?	Because that's what heroes do.
Because that's what heroes do.	Wait, sorry. I didn't time that right. And, now!
Thanks for scaring away my company and drenching my workplace in brains.  	Who are you?
Who are you?	Don't you remember? I'm Skurge. We fought together on Vanaheim.
Don't you remember? I'm Skurge. We fought together on Vanaheim.	Right. Where's Heimdall?
Right. Where's Heimdall?	That traitor. No one knows, he's a fugitive of the throne.
That traitor. No one knows, he's a fugitive of the throne.	Traitor?
Oh, shit. My son! Thor has returned! Greetings my boy.	It's an interesting play. What's it called?
It's an interesting play. What's it called?	The Tragedy of Loki of Asgard. The people wanted to commemorate him.
The Tragedy of Loki of Asgard. The people wanted to commemorate him.	A little less weasely.  Less greasy maybe.  
A little less weasely.  Less greasy maybe.  	You know what this is?
You know what this is?	The skull of Surtur? That's a formidable weapon.
The skull of Surtur? That's a formidable weapon.	 Lock this in a vault so it doesn't turn into a giant monster and destroy the whole planet 
 Lock this in a vault so it doesn't turn into a giant monster and destroy the whole planet 	So it's back to Midgard for you, is it?
Every night I see Asgard fall into ruins...	That's just a silly dream... Signs of an overactive imagination.
Well, it is best to respect our neighbors' freedom.	Of course, the freedom to be massacred.
Of course, the freedom to be massacred.	Yes, besides, I have been rather busy myself.
Yes, besides, I have been rather busy myself.	Watching theatre.
Watching theatre.	Board meetings, and security council meetings...
Board meetings, and security council meetings...	You really going to make me do it?
You really going to make me do it?	Do what?
Ow-ow-ow! Alright! I know exactly where he is.	I swear, I left him right here.
I swear, I left him right here.	Right here on the sidewalk? Or right there, where the building that's being demolished? Great planning.
Right here on the sidewalk? Or right there, where the building that's being demolished? Great planning.	How was I supposed to know? Can't see into the future. I'm not a witch.
How was I supposed to know? Can't see into the future. I'm not a witch.	Then why do you dress like one?
Then why do you dress like one?	Hey.
Hey.	I can't believe you're alive. I saw you die. I mourned you, I cried for you.
She didn't dump me, you know. I dumped her. It was a mutual dumping.	What's this, what are you doing!?
What's this, what are you doing!?	This... isn't me.
Thor Odinson.	God of Thunder.
God of Thunder.	You can put down the umbrella.
You can put down the umbrella.	So earth has wizards now?
So earth has wizards now?	The preferred term is "Master of the Mystic Arts."
The preferred term is "Master of the Mystic Arts."	Alright wizard, who are you? Why should I care?
Alright wizard, who are you? Why should I care?	My name is Doctor Stephen Strange and I have some questions for you. Take a seat.
My name is Doctor Stephen Strange and I have some questions for you. Take a seat.	Tea?
Tea?	I don't drink tea.
I don't drink tea.	What do you drink?
Loki, lift your magic.	Took me quite a while to break free from your spell. Frigga would have been proud.
Took me quite a while to break free from your spell. Frigga would have been proud.	Come and sit with me. I don't have much time.
Come and sit with me. I don't have much time.	I know that we failed you, but we can make this right.
I know that we failed you, but we can make this right.	I failed you. It is upon us...Ragnarok.
I failed you. It is upon us...Ragnarok.	No, I've stopped Ragnarok. I put an end to Surtur.
No, I've stopped Ragnarok. I put an end to Surtur.	I cannot keep her away any longer.  
I cannot keep her away any longer.  	Father, who are you talking about?
Father, who are you talking about?	The Goddess of Death. Hela. My first born. Your sister.
. . and once she gets there, her powers will be limitless.  	Whatever she is, we can stop her. We can face her together.
Whatever she is, we can stop her. We can face her together.	No we won't. I'm on a different path now. This you must face alone.
No we won't. I'm on a different path now. This you must face alone.	I love you my sons.
I love you my sons.	Look at that.
Are you a fighter or are you food?	I'm just passing through.
Whoever you are... whatever you've done, surrender now! Or we will show you know mercy.	Whoever I am? Did you listen to a word I said?
Whoever I am? Did you listen to a word I said?	This is your last warning!
This is your last warning!	I thought you'd be happy to see me.
. . all because they couldn't see the future.  Sad.  Oh !  Look, still alive.  	Change of heart?
Change of heart?	Go back to whatever cave you crept out of you evil demoness!
But what is this place? The answer in Sakaar.	Surrounded by cosmic gateways, Sakaar lives on the edge of the known and unknown.
Surrounded by cosmic gateways, Sakaar lives on the edge of the known and unknown.	But here on Sakaar, you are significant.  You are valuable.  Here, you are loved.  
But here on Sakaar, you are significant.  You are valuable.  Here, you are loved.  	What...the hell?
What...the hell?	And no one loves you more than the Grandmaster.
And no one loves you more than the Grandmaster.	The creator of Sakaar and the father of the Contest of Champions.  
The creator of Sakaar and the father of the Contest of Champions.  	 You are the property of the Grandmaster Congratulations !  You will meet the Grandmaster in five seconds.  
Trash.	No, not trash. Were you waiting just to call her that? It doesn't start with a "B."
" Because I always say you're the best She brought me my precious beloved Champion, you know.  	You say that every time she's here.
 This is my very good friend over here, Miek He's an insect and has knives for hands.  	You're a Kronan, aren't you?
You're a Kronan, aren't you?	That I am.
That I am.	How'd you end up in here?
I don't know if you'd be interested in something like that.  Do you reckon you'd be interested? 	How did you...
How did you...	Yeah, no. This whole thing is a circle. But not a real circle, more like a freaky circle.
Yeah, no. This whole thing is a circle. But not a real circle, more like a freaky circle.	This doesn't make any sense.
This doesn't make any sense.	No, nothing makes sense here. The only thing that does make sense, is that nothing makes sense.
No, nothing makes sense here. The only thing that does make sense, is that nothing makes sense.	Has anyone here fought the Grandmaster's Champion?
Has anyone here fought the Grandmaster's Champion?	Doug has. Doug! Oh, right, Doug's dead. That's right. Everyone who fights the Grandmaster's champion perishes.
Doug has. Doug! Oh, right, Doug's dead. That's right. Everyone who fights the Grandmaster's champion perishes.	What about you? You're made of rocks.
Odin's treasures.	Fake.
Fake.	Most of the stuff in here is fake.
Most of the stuff in here is fake.	Or weak.
?  Disgusting slobs Thor. . . wanna use a big wooden fork? 	No.
No.	Yeah, not really useful unless you're fighting off three vampires that were huddled together.
Yeah, not really useful unless you're fighting off three vampires that were huddled together.	I really wish I had my hammer.
And when I spun it really, really fast it gave me the ability to fly.  	You rode a hammer?
You rode a hammer?	No, I didn't ride the hammer.
No, I didn't ride the hammer.	The hammer rode you on your back?
The hammer rode you on your back?	No. I used to spin it really fast, and it would pull me off the...
No. I used to spin it really fast, and it would pull me off the...	Oh my God. The hammer pulled you off?
Oh my God. The hammer pulled you off?	Every time I threw it, it would always come back to me.  
Gotta watch out for those Asgardians, man. They are hard to perish.	Asgardian?
Asgardian?	Hey! Hey!
Hey! Hey!	Do not zap me with that thing. I just wanna talk. Asgard is in danger.
Now, don't you move. My hands ain't as steady as they used to be.	By Odin's beard, you shall not cut my hair... lest you feel the wrath of the might Thor.
What are you doing? It's me.	Banner, we're friends. This is crazy. I don't want to hurt you!
Banner, we're friends. This is crazy. I don't want to hurt you!	Here we go.
Hey, big guy. The sun's getting real low.	That's it. The sun's going down. I won't hurt you anymore. No one will.
That's it. The sun's going down. I won't hurt you anymore. No one will.	Yes! That's how it feels! I'm just a huge fan of the sport.
Yes! That's how it feels! I'm just a huge fan of the sport.	All right. Screw it.
All right. Screw it.	I know you're in there, Banner. I'll get you out!
Thunder! Thunder! Thunder!	Thunder! Thunder! Thunder!
What is that noise?	The common folk aren't exactly falling in line. There's a resistance trying to knock down the front gates.
The common folk aren't exactly falling in line. There's a resistance trying to knock down the front gates.	Tell me about yourself, Skurge.
Tell me about yourself, Skurge.	Well, me dad was a stonemason, me mum was-
Well, me dad was a stonemason, me mum was-	I'll just stop you there. What I meant was what is your ambition?
I'll just stop you there. What I meant was what is your ambition?	I just want a chance to prove myself.
I just want a chance to prove myself.	But mainly to execute people.  Still a great honor.  (beat) I was Odin's executioner.  
Are we cool?	It's Hulk in a hot tub. How long have you been like that?
It's Hulk in a hot tub. How long have you been like that?	Like what?
Like what?	Like this. Big, green, ...stupid.
Like this. Big, green, ...stupid.	Hulk always Hulk.
Hulk always Hulk.	How'd you get here?
How'd you get here?	Winning.
Were they wearing one of these when you won? How'd you arrive here?	Quinjet.
Quinjet.	Yes. Where is the Quinjet now?
Yes. Where is the Quinjet now?	That's naked. He's very naked. It's in my brain now.
That's naked. He's very naked. It's in my brain now.	Quinjet.
Quinjet.	You're gonna love Asgard.  It's big.  It's golden.  Shiny.  
You're gonna love Asgard.  It's big.  It's golden.  Shiny.  	Hulk stay.
Hulk stay.	No, no, no. My people need me to get back to Asgard. We must prevent Ragnarok.
No, no, no. My people need me to get back to Asgard. We must prevent Ragnarok.	Rag-na-ruh?
This is what friends do.  They support each other.  	You're Banner's friend.
You're Banner's friend.	I'm not Banner's friend. I prefer you.
I'm not Banner's friend. I prefer you.	Banner's friend.
Banner's friend.	I don't even like Banner. "I'm into numbers and science and stuff."
I don't even like Banner. "I'm into numbers and science and stuff."	Thor go. Hulk Stay.
Thor go. Hulk Stay.	Fine. Stay here. Stupid place. It's hideous, by the way. The red, the white. Just pick a color.
Fine. Stay here. Stupid place. It's hideous, by the way. The red, the white. Just pick a color.	Smash you.
Smash you.	You didn't smash anything. I won that fight
You didn't smash anything. I won that fight	I smashed you.
I smashed you.	Yeah, sure, sure.
Yeah, sure, sure.	Baby Arms.
Baby Arms.	What?
Moron! You big child.	Thor go!
Thor go!	I am going.
I see you. But you are far away.	What's going on here?
What's going on here?	Come see for yourself.
Come see for yourself.	But if the garrison falls our only escape will is Bi-Frost.  
But if the garrison falls our only escape will is Bi-Frost.  	You're talking about evacuating Asgard?
I'm not sad, you idiot. I'm pissed off! Angry. I lost my father. I lost my hammer.	Whining and crying. Cry like baby.
Whining and crying. Cry like baby.	You're not even listening.
You're not even listening.	Don't kick stuff.
Don't kick stuff.	You're being a really bad friend.
You're being a really bad friend.	You bad friend!
You bad friend!	You know what we call you?
You know what we call you?	No.
You're tiny Avenger!	What, are you crazy?
What, are you crazy?	Yes.
Yes.	You know what? Earth does hate you.
You know what? Earth does hate you.	No.
No.	I'm sorry I said those things. You're not the stupid Avenger. Nobody calls you the stupid Avenger.
I'm sorry I said those things. You're not the stupid Avenger. Nobody calls you the stupid Avenger.	It's okay.
It's okay.	You just can't go around throwing shields at people. Could have killed me.
You just can't go around throwing shields at people. Could have killed me.	I know. I'm sorry. I just get so angry all the time. Hulk always, always angry.
I know. I'm sorry. I just get so angry all the time. Hulk always, always angry.	I know. We're the same, you and I. We're just a couple of hot-headed fools.
I know. We're the same, you and I. We're just a couple of hot-headed fools.	Yeah, same. Hulk like fire, Thor like water.
Don't get familiar.	This is about the people.  They're dying and they're you're people, too.  
This is about the people.  They're dying and they're you're people, too.  	Forget it. I have.
Forget it. I have.	Okay.
Okay.	Okay.
Okay.	Good. Great.
Good. Great.	Great.
Great.	Thank you.
Thank you.	For what?
For what?	For this.
For this.	Didn't see that did you?
I choose to run toward my problems and not away from them. Because that's what...	Because that's what heroes do.
All right. Come on.	Voice verification required.
Voice verification required.	Thor.
Thor.	Access denied.
Access denied.	Thor, son of Odin.
Thor, son of Odin.	Access denied.
Access denied.	God of Thunder.
God of Thunder.	Access denied.
Access denied.	Strongest Avenger.
Strongest Avenger.	Access denied.
Access denied.	Strongest Avenger!
Strongest Avenger!	Access denied.
Access denied.	Damn you, Stark. Point Break.
Sun's going down.  That's it, breathe.  I won't hurt you.  Sun's going down.  	...Thor?
...Thor?	Yeah.
Yeah.	What happened to your hair?
What happened to your hair?	Some creepy old man cut it off.
Some creepy old man cut it off.	It looks good.
It looks good.	Thanks.
Thanks.	Where are we? How's Nat?
Where are we? How's Nat?	Nat is good, I'm sure.
Nat is good, I'm sure.	And what about Sokovia?
And what about Sokovia?	Sokovia?
Sokovia?	The city, Sokovia. Did we save it?
The city, Sokovia. Did we save it?	Banner, listen.
Banner, listen.	What?
Seductive GOD of Thunder. We need to move.	Oh, no. This is bad. This is really, really bad. Thor, I think I'm freaking out.
Oh, no. This is bad. This is really, really bad. Thor, I think I'm freaking out.	No, no, no. Don't freak out. You're okay. Put these on.
No, no, no. Don't freak out. You're okay. Put these on.	These are Tony's clothes.
These are Tony's clothes.	I know, come on.
I know, come on.	Is he here?
What have you done!?	I don't answer to you, lackey.
Why would you help my brother escape with that green fool?	I don't help anyone.
I don't help anyone.	You're a Valkyrie. I thought the Valkyrie all died gruesome deaths?
You're a Valkyrie. I thought the Valkyrie all died gruesome deaths?	Choose your next words wisely.
The sun's going down. It's getting really low. The sun's going down. It's getting real low.	Would you stop saying that!?
Would you stop saying that!?	I just need you to stay calm.
I just need you to stay calm.	Calm!? I'm on an alien planet!
Calm!? I'm on an alien planet!	It's just a planet. You've been on a planet before.
It's just a planet. You've been on a planet before.	Yeah! One!
Yeah! One!	Now you've been on two. That's a good thing. It's a new experience.
If I turn into the Hulk, I am never gonna come back again. And you don't care.	No, no. I'm putting together the team. The Hulk is the fire.
No, no. I'm putting together the team. The Hulk is the fire.	Wait, you're just using me to get to the Hulk.
Wait, you're just using me to get to the Hulk.	What? No!
What? No!	It's gross. You don't care about me. You're not my friend.
It's gross. You don't care about me. You're not my friend.	No! I don't even like the Hulk. He's all like... "smash, smash, smash." I prefer you.
No! I don't even like the Hulk. He's all like... "smash, smash, smash." I prefer you.	Thanks.
Thanks.	But if I'm being honest, when it comes to fighting evil beings, he is very powerful and useful.
But if I'm being honest, when it comes to fighting evil beings, he is very powerful and useful.	Yeah, Banner's powerful and useful, too.
Yeah, Banner's powerful and useful, too.	Is he though?
Is he though?	How many PhDs does Hulk have? Zero. How many PhDs does Banner have? Seven.
How many PhDs does Hulk have? Zero. How many PhDs does Banner have? Seven.	Fine, you don't have to fight anyone. But we're in danger here, so we have to move.
I need a disguise. I'm a fugitive.	I need a disguise.
I need a disguise.	You are the disguise.
You are the disguise.	I'll be Tony Stark.
I'll be Tony Stark.	What?
What?	Yeah. Tony and the gypsy.
Yeah. Tony and the gypsy.	No, no you're not Tony. You're Bruce Banner.
No, no you're not Tony. You're Bruce Banner.	Then why did you dress me up like Tony?
Then why did you dress me up like Tony?	Because you were naked.
Because you were naked.	Okay, I'll give you that.
Okay, I'll give you that.	What are you doing? Stop doing that!
What are you doing? Stop doing that!	Tony wears his pants super tight!
Tony wears his pants super tight!	Why are you being so weird?
Sakaaar seemed like the best place to drink and forget and to die one day.  	I was thinking that you drink too much, and that probably was going to kill you.
I was thinking that you drink too much, and that probably was going to kill you.	. .  it may as well be driving my sword through the heart of that murderous hag.  
. .  it may as well be driving my sword through the heart of that murderous hag.  	Good.
Good.	Yeah. So I'm saying that I wanna be on the team. Has it got a name?
Is that... a Dragonfang?	It is.
It is.	My God. This is the famed sword of the Valkyrie.
I may eve have stolen the access codes to his security system.  	And suddenly you're overcome with an urge to do the right thing.
?  Or are they eggs ?  Looks like eggs 	I'm looking for Korg.
I'm looking for Korg.	Who's asking? I know you're asking. Is anyone else asking, or is it just you?
Who's asking? I know you're asking. Is anyone else asking, or is it just you?	The Lord of Thunder sends his best.
Don't know. But the Arena's mainframe for the Obedience Disks have been deactivated and the slaves have armed themselves.	Oh! I don't like that word!
Oh! I don't like that word!	Mainframe?
Mainframe?	No. Why would I not like "mainframe?" No, the "S" word.
No. Why would I not like "mainframe?" No, the "S" word.	Sorry, the "prisoners with jobs" have armed themselves.
Hey, so listen, we should talk.	I disagree. Open communication was never our family's forte.
Hello!	Hi!
Hi!	We might as well be strangers now.  "Two sons of the crown" set adrift.  
Here's the thing. I'm probably better off staying here on Sakaar.	That's exactly what I was thinking.
That's exactly what I was thinking.	...Did you just agree with me?
...Did you just agree with me?	This place is perfect for you. It's savage, chaotic, lawless. Brother, you're going to do GREAT here.
This place is perfect for you. It's savage, chaotic, lawless. Brother, you're going to do GREAT here.	Do you truly think so little of me?
It's probably for the best that we never see one another again.	That's what you always wanted.
That's what you always wanted.	Hey, let's do "Get Help."
Hey, let's do "Get Help."	What?
What?	"Get Help."
"Get Help."	No.
No.	Come on, you love it.
Come on, you love it.	I hate it.
I hate it.	It's great. IT works every time.
It's great. IT works every time.	It's humiliating.
It's humiliating.	Do you have a better plan?
Do you have a better plan?	No.
Get help! Please! My brother, he's dying.	Get help! Help him!
Get help! Help him!	Classic.
Classic.	I still hate it. It's humiliating.
I still hate it. It's humiliating.	Not for me, it's not.
Not for me, it's not.	Which one's the ship she told us to get?
Which one's the ship she told us to get?	The Commodore.
Never one for sentiment, were you?	Easier to let it burn.
Easier to let it burn.	I agree.
I agree.	Oh brother, you're becoming predictable. I trust you, you betray me. Round and round in circles we go.
I should probably go and help.	Here, take the wheel.
Here, take the wheel.	No. I don't know how to fly one of these.
No. I don't know how to fly one of these.	You're a scientist. Use one of your PhDs.
Thank you.	Hey man, we're about to jump on that ginormous spaceship. You wanna come?
Hey man, we're about to jump on that ginormous spaceship. You wanna come?	You do seem like you're in desperate need of leadership.
Now the ship has guns.	I'll take it from here.
I'll take it from here.	I found this in the armory.
Sister.	You're still alive.
You're still alive.	I love what you've done with the place. Redecorating, I see.
I love what you've done with the place. Redecorating, I see.	It seems our father's solution to every problem was to cover it up.
It seems our father's solution to every problem was to cover it up.	Or to cast it out. He told you you were worthy. He said the same thing to me.
To foster peace, to protect life. To have you.	But it can't be you.  You're just. . . the worst.  
But it can't be you.  You're just. . . the worst.  	Okay, get up. You're in my seat.
Okay, get up. You're in my seat.	You know, Father once told me that a wise king never seeks out war.
This stupid dog won't die!	Everything's going to be okay. I got this. You want to know who I am?
Everything's going to be okay. I got this. You want to know who I am?	What the hell are you talking about?
Are you Thor, God of Hammers?	That hammer helped you control your power, focus it. But it was never the source of your strength.
That hammer helped you control your power, focus it. But it was never the source of your strength.	It's too late. She's already taken Asgard.
It's too late. She's already taken Asgard.	It is wherever our people stand.  And right now those people need you.  
It is wherever our people stand.  And right now those people need you.  	I'm not as strong as you.
HELA! Enough!	You want Asgard? It's yours.
You want Asgard? It's yours.	Whatever game you're playing, it won't work. You can't defeat me.
Whatever game you're playing, it won't work. You can't defeat me.	No, but he can.
It will become a haven for all people and aliens of the universe. . .  	Nope, those foundations are gone. Sorry.
It suits you.	Perhaps you're not so bad after all, brother.
Perhaps you're not so bad after all, brother.	Maybe not.
Maybe not.	Thank you, Loki.
Thank you, Loki.	And if you were here, I might even give you a hug.
