Alright everyone, this is a stick- up! Don't anybody move! Now empty that safe!	Ooh! Money. Money. Money.
Ooh! Money. Money. Money.	Stop it! Stop it, you mean old potato!
Stop it! Stop it, you mean old potato!	Quiet Bo Peep, or your sheep get run over!
Quiet Bo Peep, or your sheep get run over!	Heeeeelp! BAAAAA! Heeeelp us!
Heeeeelp! BAAAAA! Heeeelp us!	Oh, no! Not my sheep! Somebody do something!
Oh, no! Not my sheep! Somebody do something!	Reach for the sky.
Reach for the sky.	Oh, no! Sheriff Woody!!
Oh, no! Sheriff Woody!!	I'm here to stop you, One-Eyed Bart.
I'm here to stop you, One-Eyed Bart.	Doooooh! How'd you know it was me!
Doooooh! How'd you know it was me!	Are you gonna come quietly?
Are you gonna come quietly?	You can't touch me Sheriff! I brought my attack dog with a built- in force field!
You're goin' to jail, Bart.	Say good-bye to the wife and tatertots.
Say good-bye to the wife and tatertots.	You saved the day again, Woody.
Wow! Cool!	Whadda ya think?
Can we leave this up 'til we move?	Well, sure, we can leave it up.
Well, sure, we can leave it up.	Yeah!
Yeah!	Now go get Molly. Your friends are going to be here any minute.
Now go get Molly. Your friends are going to be here any minute.	Okay.
Howdy, Little Lady!	Somebody's poisoned the waterhole.
Oh...well alright, you can be red if you want.	Not now, Slink. I've got some bad news.
Not now, Slink. I've got some bad news.	Bad news?!
Bad news?!	Sh-h-h-h-h!!
Sh-h-h-h-h!!	Just gather everyone up for a staff meeting and be happy!!
Just gather everyone up for a staff meeting and be happy!!	Got it.
Hey Etch! Draw!	Oh!! You got me again, Etch! You've been working on that draw. Fastest knobs in the west.
Oh, how ya doin', Rex?	Were you scared? Tell me honestly.
Were you scared? Tell me honestly.	I was close to being scared that time.
Yeah, alright!!	Hey, watch it!
I'm Buzz Lightyear, Space Ranger, Universe Protection Unit.  My ship has crash landed here by mistake.  	Yes, it is a mistake, because, you see, the bed, here, is my spot.
It's too short! We need more monkeys!	There aren't any more! That's the whole barrel.
Can I help pump the gas?	Sure! I'll even let you drive.
Oh, great. How am I gonna convince those guys it was an accident?	Buzz!
Buzz!	Huh? 
Huh? 	Right? Buddy?
Oh. Oh, that's good.	But we're not on my planet, are we?
Shut up! Just shut up, you idiot!!	Sheriff, this is no time to panic.
Pizza Planet...Andy!	Oh, no! I can't show my face in that room without Buzz.
Oh, no! I can't show my face in that room without Buzz.	Buzz! Buzz, come back!
Wait a minute! No Buzz! This way! There's a special ship. I just saw it!	You mean it has hyperdrive?
You mean it has hyperdrive?	Hyper-active hyperdrive, and astro...uh, turf.
Oo-o-o-o-o-o...	Greetings! I am Buzz Lightyear! I come in peace!
He must go! Do not fight the claw! Do not anger the claw! He has been chosen.	Alright! Double prizes!
Ready, set, NOW.	Hannah! Hey, Hannah!!!
Hannah! Hey, Hannah!!!	What?
What?	Did I get my package in the mail?
Did I get my package in the mail?	I dunno.
I dunno.	Whaddaya mean, you don't know?
Whaddaya mean, you don't know?	I don't know!
I don't know!	Oh no, Hannah!
Oh no, Hannah!	What?
What?	Look! Janie!
Look! Janie!	Hey!!
Sid! Sid!...	Oh, no. We have a sick patient here, nurse. Prepare the O.R., STAT!
Oh, no. We have a sick patient here, nurse. Prepare the O.R., STAT!	Sid, give her back! Give her back now! I'm telling!
Sid, give her back! Give her back now! I'm telling!	Patient is... (straining while tightening vise) ...pre-e-epped.
I don't believe that man's ever been to medical school.	Doctor, you've done it! (running to the door) Hannah?
She's lying! Whatever she says it's not true!	We are gonna die. I'm outta here!
May day! May day! Come in, Star Command! Send reinforcements!... Star Command, do you copy?	I've set my laser from stun to kill.
Oh, you idiot! You're a toy! Use your karate chop action!	Get away! Hoo-cha! Hoo-cha!
Get away! Hoo-cha! Hoo-cha!	Hey!! Hey! How are you doing that? Stop that!
Hey!! Hey! How are you doing that? Stop that!	Back! Back, you savages! Back!
Back! Back, you savages! Back!	Woody, stop it!!
Giddy-up partner!...	...We got to get this wagon train a movin'!
To Infinity and Beyond!	Not a flying toy.
M-o-o-om? Mom, have you seen my Sally doll?	What, dear? What was that?
...I'm just a little depressed, that's all. I can get through this.	Oh, I'm a sham!!
Oh, I'm a sham!!	Sh-h-h-h-h!! Quiet, Buzz.
Out the window...Buzz, you're a genius!	Come on, this way!
Fine. Let Sid trash you. But don't blame me.	It came! It finally came!
It came! It finally came!	The big one.
Ps-s-s-s-t! Psst! Hey, Buzz!	Hey! Get over here and see if you can get this tool box off me.
Hey! Get over here and see if you can get this tool box off me.	Oh, come on, Buzz. I...Buzz, I can't do this without you. I need your help.
Oh, come on, Buzz. I...Buzz, I can't do this without you. I need your help.	I can't help. I can't help anyone.
Andy's house. Sid's house. What's the difference.	Oh, Buzz, you've had a big fall. You must not be thinking clearly.
Yeah, right.	!  You are HIS toy 
Now let's get you out of this thing.  	Yes Sir!
Woody! It's the moving van.	We've got to get out of here...NOW.
We've got to get out of here...NOW.	C'mon, Buzz.
C'mon, Buzz.	Alright. Buzz! Hey! I'm out!
...and counting. Ten! Nine! Eight! Seven! Six! Five! Four! Three! Two!... One!...	Reach for the sky!!
Reach for the sky!!	Huh?
Huh?	This town ain't big enough for the two of us!
This town ain't big enough for the two of us!	What?!
What?!	Somebody's poisoned the water hole...
Somebody's poisoned the water hole...	It's busted.
It's busted.	Who are you callin' busted, Buster?!
Who are you callin' busted, Buster?!	We don't like being blown up, Sid, or smashed, or ripped apart. . .  
We don't like being blown up, Sid, or smashed, or ripped apart. . .  	W-w-w-we?
W-w-w-we?	That's right. Your toys.
That's right. Your toys.	Because if you don't, we'll find out, Sid.  We toys can see. . .  
Because if you don't, we'll find out, Sid.  We toys can see. . .  	...everything.
The toys! The toys are alive!	N-N-Nice dolly...
Aaaaaahh!! Get away, you stupid dog! Down! Down!	Hold on, Woody!
No wait! You don't understand! Buzz is out there! We've gotta help him!!	Toss 'im overboard!
Toss 'im overboard!	No, no, no, wait!
Who-o-o-oa! Woody!	Well, thanks for the ride.
Well, thanks for the ride.	Look out!!
I can't hold on much longer!	Slink! Hang on!
Woody! The rocket!	The match!
No-o-o! No-no-no-no! No-o-o!	Woody?! What are you doing?
Woody?! What are you doing?	Hold still, Buzz!
Hold still, Buzz!	Ha-ha!!
Ha ha!! To Infinity and Beyond!!	Uh, Buzz?! We missed the truck!
Hey! Wow!	What? What is it?
What? What is it?	Woody! Buzz!
Woody! Buzz!	Oh, great, you found them. Where were they?
Oh, great, you found them. Where were they?	Here! In the car!
